Welcome to the surveillance society.  Every citizen has been scanned, chipped, folded, spindled and mutilated - and it's enough to make you scream.

Valley of Steel
A tale of the surveillance society by The Custodian of http://everything2.com
Release 1 / Serial number 130310 / Inform 7 build 6G60 (I6/v6.32 lib 6/12N) SD

Bedroom
Your bedroom is rather boring.  It contains your bed - currently unmade - and the usual assortment of bedroom furnishings including a bedside table, next to the bed.

On the bedside table are a watch and a phone.

You can go north and west from here.

>gonear the fence
South Primrose Lane
Primrose Lane, just in front of your home.  To the south is a boarded-up empty house; sumac trees can be seen peeking over the top of the dilapidated fencing.  The fence has a plastic tarp strung behind it which prevents you from seeing much of the house.  To the west is a single-family home with a large burglar alarm warning sign and an enormous dog on the front lawn.  To the east is your building's front path.

You can go north and east from here.

>cut the fence
What do you want to cut it with?

>rules
Rules tracing now switched on. Type "rules off" to switch it off again, or "rules all" to include even rules which do not apply.

>cut fence
[Rule "Instead of cutting the fence" applies.]
What do you want to cut it with?

[Rule "scene description text rule" applies.]

>i
[Rule "print empty inventory rule" applies.]
[Rule "print standard inventory rule" applies.]
You are carrying:
  a backpack (being worn and open but empty)

[Rule "report other people taking inventory rule" applies.]

>rules
Rules tracing now switched on. Type "rules off" to switch it off again, or "rules all" to include even rules which do not apply.

>gonear key
[Rule "determine visibility ceiling rule" applies.]
[Rule "room description heading rule" applies.]
Entry
[Rule "room description body text rule" applies.]
This is the small entryway to your apartment. A pile of mail, most of it unread, covers the small table just inside your front door.  The apartment hallway is to the south.  To the west is your office, and to the east is your bathroom.

[Rule "room description paragraphs about objects rule" applies.]
[Rule "don't mention player's supporter in room descriptions rule" applies.]
[Rule "don't mention scenery in room descriptions rule" applies.]
[Rule "don't mention undescribed items in room descriptions rule" applies.]
[Rule "set pronouns from items in room descriptions rule" applies.]
[Rule "offer items to writing a paragraph about rule" applies.]
[Rule "use initial appearance in room descriptions rule" applies.]
[Rule "describe what's on scenery supporters in room descriptions rule" applies.]
[Rule "don't mention player's supporter in room descriptions rule" applies.]
[Rule "don't mention scenery in room descriptions rule" applies.]
[Rule "don't mention undescribed items in room descriptions rule" applies.]
[Rule "set pronouns from items in room descriptions rule" applies.]
[Rule "offer items to writing a paragraph about rule" applies.]
[Rule "use initial appearance in room descriptions rule" applies.]
[Rule "describe what's on scenery supporters in room descriptions rule" applies.]
[Rule "don't mention player's supporter in room descriptions rule" applies.]
[Rule "don't mention scenery in room descriptions rule" applies.]
[Rule "don't mention undescribed items in room descriptions rule" applies.]
[Rule "set pronouns from items in room descriptions rule" applies.]
[Rule "offer items to writing a paragraph about rule" applies.]
[Rule "use initial appearance in room descriptions rule" applies.]
[Rule "describe what's on scenery supporters in room descriptions rule" applies.]
You can see a side table (on which is a car key) here.

[Rule "check new arrival rule" applies.]
[Rule "explosive residue rule" applies.]
[Rule "exits rule" applies.]
[Rule "darkness hides exits rule" applies.]
[Rule "check obvious doors rule" applies.]
[Rule "darkness hides exits rule" applies.]
[Rule "darkness hides exits rule" applies.]
[Rule "darkness hides exits rule" applies.]
You can go [Rule "darkness hides exits rule" applies.]
[Rule "check obvious doors rule" applies.]
[Rule "darkness hides exits rule" applies.]
[Rule "darkness hides exits rule" applies.]
[Rule "darkness hides exits rule" applies.]
north through the Front door (closed), south, east and west from here.

[Rule "list notable events rule" applies.]
[Rule "other people looking rule" applies.]

>rules
Rules tracing now switched on. Type "rules off" to switch it off again, or "rules all" to include even rules which do not apply.

>rules off
Rules tracing now switched off. Type "rules" to switch it on again.

>take key
Taken.

* * *

>open key
That's not something you can open.

>open key with knife
You carefully cut open the car keys with your knife and peel back the rubber to reveal a broadcast chip and a memory chip.

>undo
Home Office
[Previous turn undone.]

* * *

>rules
Rules tracing now switched on. Type "rules off" to switch it off again, or "rules all" to include even rules which do not apply.

>open key with knife
[Rule "Instead of unlocking the car key with the knife" applies.]
[Rule "Check cutting the car key with something" applies.]
[Rule "Check cutting it with" applies.]
[Rule "Carry out cutting the car key with something" applies.]
You carefully cut open the car keys with your knife and peel back the rubber to reveal a broadcast chip and a memory chip.

[Rule "Every Turn during Transit Stop" applies.]
[Rule "scene description text rule" applies.]

>purloin blue jacket
[Purloined.]

>remove blue jacket's antitheft tag with knife
[Rule "Check removing it with" applies.]
That doesn't seem like an appropriate tool.

[Rule "Every Turn during Transit Enroute" applies.]

* * *

Welcome to the surveillance society.  Every citizen has been scanned, chipped, folded, spindled and mutilated - and it's enough to make you scream.

Valley of Steel
A tale of the surveillance society by The Custodian of http://everything2.com
Release 1 / Serial number 130310 / Inform 7 build 6G60 (I6/v6.32 lib 6/12N) SD

Bedroom
Your bedroom is rather boring.  It contains your bed - currently unmade - and the usual assortment of bedroom furnishings including a bedside table, next to the bed.

On the bedside table are a watch and a phone.

You can go north and west from here.

>purloin breaching charge
[Purloined.]

>attach breaching charge to bed
You put the disarmed Breaching Charge on the bed.

>l
Bedroom
Your bedroom is rather boring.  It contains your bed - currently unmade - and the usual assortment of bedroom furnishings including a bedside table, next to the bed.

On the bedside table are a watch and a phone.

On the bed is a disarmed Breaching Charge.

You can go north and west from here.

>take charge
Taken.

>purloin descender
[Purloined.]

>wear descender
You put on the descender.

>gonear observation window
Seating Area
The corridor ends in a small open seating area.  Through the windows the myriad internal windows of the spacescraper's other suites can be seen.  There is a door leading north, presumably to the rest of the office space.  It is closed and locked.  An observation window looks out east onto a ledge over the spacescraper's hollow core.

You can go east and west from here.

>attach charge to window
You put the disarmed Breaching Charge on the observation window.

>l
Seating Area
The corridor ends in a small open seating area.  Through the windows the myriad internal windows of the spacescraper's other suites can be seen.  There is a door leading north, presumably to the rest of the office space.  It is closed and locked.  An observation window looks out east onto a ledge over the spacescraper's hollow core.

On the observation window is a disarmed Breaching Charge.

You can go east and west from here.

There is a Public Surveillance Notice here.

>l window
A wall-sized armorcrys window which looks out over a ledge jutting into the airspace of the spacescraper's atrium.  The ledge, one of many spotted around the interior of the atrium, holds some flowers and a single tree, all in plascrete planters.  A breaching charge is stuck to the window.

On the observation window is a disarmed Breaching Charge.

* * *

>purloin breaching charge
[Purloined.]

>gonear observation window
Seating Area
The corridor ends in a small open seating area.  Through the windows the myriad internal windows of the spacescraper's other suites can be seen.  There is a door leading north, presumably to the rest of the office space.  It is closed and locked.  An observation window looks out east onto a ledge over the spacescraper's hollow core.

You can go east and west from here.

* * *

>attach charge to window
You put the disarmed Breaching Charge on the observation window.

>rules
Rules tracing now switched on. Type "rules off" to switch it off again, or "rules all" to include even rules which do not apply.

>x window
[Rule "standard examining rule" applies.]
A wall-sized armorcrys window which looks out over a ledge jutting into the airspace of the spacescraper's atrium.  The ledge, one of many spotted around the interior of the atrium, holds some flowers and a single tree, all in plascrete planters.  A breaching charge is stuck to the window.

[Rule "examine directions rule" applies.]
[Rule "examine containers rule" applies.]
[Rule "examine supporters rule" applies.]
On the observation window is a disarmed Breaching Charge.

[Rule "examine devices rule" applies.]
[Rule "examine undescribed things rule" applies.]
[Rule "report other people examining rule" applies.]

>rules off
Rules tracing now switched off. Type "rules" to switch it on again.

>gonear scarred tree
Atrium Ledge
This ledge, along with the others at the Mezzanine level, looks out over the huge hollow core of the Reserve Bank spacescraper's lower third.  The central column containing the main bouncelifts is visible perhaps fifty meters away.   Above, the roof of the atrium is hazily visible through the glare from its light fixtures some thirty floors up.  Sixty floors below, the main lobby can be made out.  To one side of the bouncelift column, the sublevel Lift Lobby can be seen one level below the lobby.  A very low glass wall surrounds the ledge for safety, but it's clear that this space isn't meant for the public.  A few holes in the plascrete floor hold scattered soil; one large planter in the center holds a scarred but defiantly unbent tree.

>attach cable to tree
You can't see any such thing.

>i
You are carrying:
  a backpack (being worn and open but empty)

>purloin descender
[Purloined.]

* * *

>wear descender
You put on the descender.

>attach cable to tree
You pass the cable around the tree and through the carabiner at the end and pull it tight, firmly attaching the cable to the tree.

>drop descender
(first taking the descender off)
Dropped.

>actions
Actions listing on.

>wear descender
[wearing the descender]
(first taking the descender)
[(1) taking the descender - silently]
[(1) taking the descender - silently - succeeded]

You put on the descender.
[wearing the descender - succeeded]

>w
[going west]
You can't maneuver through the doors with the stiff cable trailing out behind you.
[going west - ended without result]

>drop descender
[dropping the descender]
(first taking the descender off)
[(1) taking off the descender - silently]
[(1) taking off the descender - silently - succeeded]

Dropped.
[dropping the descender - succeeded]

>take descender
[taking the descender]
Taken.
[taking the descender - succeeded]

>w
[going west]

Seating Area
The corridor ends in a small open seating area.  Through the windows the myriad internal windows of the spacescraper's other suites can be seen.  There is a door leading north, presumably to the rest of the office space.  It is closed and locked.  An observation window looks out east onto a ledge over the spacescraper's hollow core.

On the observation window is a disarmed Breaching Charge.

You can go east to Atrium Ledge and west from here.

There is a Public Surveillance Notice here.
[going west - succeeded]

>e
[going east]
The observation window is quite solid.  You can't walk through it.
[going east - ended without result]

* * *

Welcome to the surveillance society.  Every citizen has been scanned, chipped, folded, spindled and mutilated - and it's enough to make you scream.

Valley of Steel
A tale of the surveillance society by The Custodian of http://everything2.com
Release 1 / Serial number 130310 / Inform 7 build 6G60 (I6/v6.32 lib 6/12N) SD

Bedroom
Your bedroom is rather boring.  It contains your bed - currently unmade - and the usual assortment of bedroom furnishings including a bedside table, next to the bed.

On the bedside table are a watch and a phone.

You can go north and west from here.

>take all
watch: Taken.
phone: Taken.

>w
Hall
The central hallway of your modest home.  It's relatively clean and neat, as there is no furniture in it.

You can go north, east to the Bedroom and west from here.

* * *

>w
Kitchen
Your kitchen is decorated in a style some four decades old, which is probably when it was last renovated.  It is fairly clean, reflecting the fact that you don't cook for yourself much.

You can see a refrigerator (closed), a thermos (closed) and a microwave oven here.

You can go north and east to the Hall from here.

>l oven
A microwave oven of perhaps a cubic foot capacity.  It is a relatively smart oven, able to determine the proper setting for whatever is placed in it using a plethora of sensors.  There is a single button (marked "ON") on the front. A side panel sports a lurid warning.

The microwave oven is currently switched off.

>open oven
You open the oven.

>l oven
A microwave oven of perhaps a cubic foot capacity.  It is a relatively smart oven, able to determine the proper setting for whatever is placed in it using a plethora of sensors.  There is a single button (marked "ON") on the front. A side panel sports a lurid warning.  The door is ajar.

The microwave oven is currently switched off.

>put watch and phone in oven
watch: Done.
phone: Done.

>push cook button
You can't see any such thing.

>push activate button
The oven won't work unless it is closed.

>close oven
You close the oven.

>push activate button
A light comes on in the microwave and it begins to hum.
The watch sparks slightly and the face darkens.
A few moments later there is a loud BING! and the microwave stops.

I beg your pardon?

>showme phone
phone - thing
location: in the oven , which is part of the microwave oven in the Kitchen
singular-named, improper-named; unlit, inedible, portable, handled, assembled
printed name: "phone"
printed plural name: none
indefinite article: none
description: "Your cell phone was a standard candybar model with a nice screen.  "Was" because apparently, in your paranoia-fueled hacking binge, you must have decided it was too easy for the government to spy on you through it, and done something about that.  Now it's dead.  The screen is black."
initial appearance: none
size: small

>restart
Are you sure you want to restart?

>yes
Welcome to the surveillance society.  Every citizen has been scanned, chipped, folded, spindled and mutilated - and it's enough to make you scream.

Valley of Steel
A tale of the surveillance society by The Custodian of http://everything2.com
Release 1 / Serial number 130227 / Inform 7 build 6G60 (I6/v6.32 lib 6/12N) SD

Bedroom
Your bedroom is rather boring.  It contains your bed - currently unmade - and the usual assortment of bedroom furnishings including a bedside table, next to the bed.

On the bedside table are a watch and a phone.

You can go north and west from here.

>showme phone
phone - thing
location: on the bedside table in the Bedroom
singular-named, improper-named; unlit, inedible, portable, assembled
printed name: "phone"
printed plural name: none
indefinite article: none
description: "Your cell phone was a standard candybar model with a nice screen.  "Was" because apparently, in your paranoia-fueled hacking binge, you must have decided it was too easy for the government to spy on you through it, and done something about that.  Now it's dead.  The screen is black."
initial appearance: none
size: small

>take all
watch: Taken.
phone: Taken.

* * *

>w
Hall
The central hallway of your modest home.  It's relatively clean and neat, as there is no furniture in it.

You can go north, east to the Bedroom and west from here.

I beg your pardon?

>w
Kitchen
Your kitchen is decorated in a style some four decades old, which is probably when it was last renovated.  It is fairly clean, reflecting the fact that you don't cook for yourself much.

You can see a refrigerator (closed), a thermos (closed) and a microwave oven here.

You can go north and east to the Hall from here.

* * *

>open oven
You open the oven.

>put phone and watch in oven
phone: Done.
watch: Done.

>switch on oven
The oven won't work unless it is closed.

>close oven
You close the oven.

>switch on oven
A light comes on in the microwave and it begins to hum.
The watch sparks slightly and the face darkens.
A few moments later there is a loud BING! and the microwave stops.

>restart
Are you sure you want to restart?

* * *

>yes
Welcome to the surveillance society.  Every citizen has been scanned, chipped, folded, spindled and mutilated - and it's enough to make you scream.

Valley of Steel
A tale of the surveillance society by The Custodian of http://everything2.com
Release 1 / Serial number 130227 / Inform 7 build 6G60 (I6/v6.32 lib 6/12N) SD

Bedroom
Your bedroom is rather boring.  It contains your bed - currently unmade - and the usual assortment of bedroom furnishings including a bedside table, next to the bed.

On the bedside table are a watch and a phone.

You can go north and west from here.

>take all
watch: Taken.
phone: Taken.

* * *

>w
Kitchen
Your kitchen is decorated in a style some four decades old, which is probably when it was last renovated.  It is fairly clean, reflecting the fact that you don't cook for yourself much.

You can see a refrigerator (closed), a thermos (closed) and a microwave oven here.

You can go north and east to the Hall from here.

>open fridge
You open the refrigerator, revealing a coffee.

>take coffee
Taken.

>open oven
You open the oven.

>put coffee and watch and phone in oven
coffee: Done.
watch: Done.
phone: Done.

>close oven
You close the oven.

>push microwave button
A light comes on in the microwave and it begins to hum.
The watch sparks slightly and the face darkens.
Steam begins to rise from the coffee.
A few moments later there is a loud BING! and the microwave stops.

>showme watch
watch - thing
location: in the oven , which is part of the microwave oven in the Kitchen
singular-named, improper-named; unlit, inedible, portable, wearable, handled, assembled; fried
printed name: "watch"
printed plural name: none
indefinite article: none
description: "A cheap digital, your watch appears to be dead."
initial appearance: none
size: small
fryDescription: "The watch sparks slightly and the face darkens."

>showme coffee
coffee - thing
location: in the oven , which is part of the microwave oven in the Kitchen
singular-named, improper-named; unlit, edible, portable, handled, assembled; hot
printed name: "coffee"
printed plural name: none
indefinite article: none
description: "The remains of your morning coffee in a convenient takeaway cup.  It is just shy of too hot.  Perfect."
initial appearance: none
size: small
cookDescription: "Steam begins to rise from the coffee."

>showme watch
watch - thing
location: in the oven , which is part of the microwave oven in the Kitchen
singular-named, improper-named; unlit, inedible, portable, wearable, handled, assembled; fried
printed name: "watch"
printed plural name: none
indefinite article: none
description: "A cheap digital, your watch appears to be dead."
initial appearance: none
size: small
fryDescription: "The watch sparks slightly and the face darkens."

* * *

Welcome to the surveillance society.  Every citizen has been scanned, chipped, folded, spindled and mutilated - and it's enough to make you scream.

Valley of Steel
A tale of the surveillance society by The Custodian of http://everything2.com
Release 1 / Serial number 130310 / Inform 7 build 6G60 (I6/v6.32 lib 6/12N) SD

Bedroom
Your bedroom is rather boring.  It contains your bed - currently unmade - and the usual assortment of bedroom furnishings including a bedside table, next to the bed.

On the bedside table are a watch and a phone.

You can go north and west from here.

>gonear scarred tree
Atrium Ledge
This ledge, along with the others at the Mezzanine level, looks out over the huge hollow core of the Reserve Bank spacescraper's lower third.  The central column containing the main bouncelifts is visible perhaps fifty meters away.   Above, the roof of the atrium is hazily visible through the glare from its light fixtures some thirty floors up.  Sixty floors below, the main lobby can be made out.  To one side of the bouncelift column, the sublevel Lift Lobby can be seen one level below the lobby.  A very low glass wall surrounds the ledge for safety, but it's clear that this space isn't meant for the public.  A few holes in the plascrete floor hold scattered soil; one large planter in the center holds a scarred but defiantly unbent tree.

>purloin descender
[Purloined.]

>tie cable to tree
You pass the cable around the tree and through the carabiner at the end and pull it tight, firmly attaching the cable to the tree.

>take descender
You already have that.

>drop descender
Dropped.

>l
Atrium Ledge
This ledge, along with the others at the Mezzanine level, looks out over the huge hollow core of the Reserve Bank spacescraper's lower third.  The central column containing the main bouncelifts is visible perhaps fifty meters away.   Above, the roof of the atrium is hazily visible through the glare from its light fixtures some thirty floors up.  Sixty floors below, the main lobby can be made out.  To one side of the bouncelift column, the sublevel Lift Lobby can be seen one level below the lobby.  A very low glass wall surrounds the ledge for safety, but it's clear that this space isn't meant for the public.  A few holes in the plascrete floor hold scattered soil; one large planter in the center holds a scarred but defiantly unbent tree.

You can see a descender here.

>showme descender
descender - thing
    cable (part of descender)
location: in Atrium Ledge
singular-named, improper-named; unlit, inedible, portable, wearable, handled, assembled
printed name: "descender"
printed plural name: none
indefinite article: none
description: "This is a small but strong-looking harness meant to be worn around the torso.  A large spool of narrow but strong-looking cable is attached to it, ending in a spliced loop."
initial appearance: none
size: medium
item-id: "M8"

>take descender
Taken.

>w
Seating Area
The corridor ends in a small open seating area.  Through the windows the myriad internal windows of the spacescraper's other suites can be seen.  There is a door leading north, presumably to the rest of the office space.  It is closed and locked.  An observation window looks out east onto a ledge over the spacescraper's hollow core.

You can go east to Atrium Ledge and west from here.

There is a Public Surveillance Notice here.

>i
You are carrying:
  a descender
  a backpack (being worn and open but empty)

>showme cable
cable - thing
location: part of the descender carried by yourself in Seating Area
singular-named, improper-named; unlit, inedible, portable, assembled; tied
printed name: "cable"
printed plural name: none
indefinite article: none
description: "A spool of extremely strong cable attached to the descender with a spliced-in carabiner at the end.  One end of the cable is looped around the scarred tree and attached with the carabiner."
initial appearance: none
size: medium

>e
The observation window is quite solid.  You can't walk through it.

>gonear scarred tree
Atrium Ledge
This ledge, along with the others at the Mezzanine level, looks out over the huge hollow core of the Reserve Bank spacescraper's lower third.  The central column containing the main bouncelifts is visible perhaps fifty meters away.   Above, the roof of the atrium is hazily visible through the glare from its light fixtures some thirty floors up.  Sixty floors below, the main lobby can be made out.  To one side of the bouncelift column, the sublevel Lift Lobby can be seen one level below the lobby.  A very low glass wall surrounds the ledge for safety, but it's clear that this space isn't meant for the public.  A few holes in the plascrete floor hold scattered soil; one large planter in the center holds a scarred but defiantly unbent tree.

* * *

Welcome to the surveillance society.  Every citizen has been scanned, chipped, folded, spindled and mutilated - and it's enough to make you scream.

Valley of Steel
A tale of the surveillance society by The Custodian of http://everything2.com
Release 1 / Serial number 130310 / Inform 7 build 6G60 (I6/v6.32 lib 6/12N) SD

Bedroom
Your bedroom is rather boring.  It contains your bed - currently unmade - and the usual assortment of bedroom furnishings including a bedside table, next to the bed.

On the bedside table are a watch and a phone.

You can go north and west from here.

>purloin memory and broadcast
[Purloined.]
[Purloined.]

>attach memory to broadcast
The contents of that memory chip aren't very useful.

>w
Hall
The central hallway of your modest home.  It's relatively clean and neat, as there is no furniture in it.

You can go north, east to the Bedroom and west from here.

* * *

>n
Entry
This is the small entryway to your apartment. A pile of mail, most of it unread, covers the small table just inside your front door.  The apartment hallway is to the south.  To the west is your office, and to the east is your bathroom.

You can see a side table (on which is a car key) here.

You can go north through the Front door (closed), south to the Hall, east and west from here.

>w
Home Office
Your home office, a room which in other homes might be a living room, is not very tidy.  Books, random equipment and empty soda cans cover most available surfaces except for your workbench and your laptop.

You can see a workbench (on which are a multitool, a lockblade knife, a soldering iron, some solder and a laptop) here.

You can go south and east to Entry from here.

>put memory in chipslot
The Download light flashes red intermittently for a few seconds before returning to a regular blinking green.

* * *

>take memory
Taken.

>attach memory to broadcast
You don't have the proper tools.

>take iron and solder
soldering iron: Taken.
solder: Taken.

>attach memory and broadcast
You can't use multiple objects with that verb.

>attach memory and br
You can't use multiple objects with that verb.

>actions
Actions listing on.

>attach memory and broadcast
You can't use multiple objects with that verb.

>rules
Rules tracing now switched on. Type "rules off" to switch it off again, or "rules all" to include even rules which do not apply.

>attach memory and broadcast
You can't use multiple objects with that verb.

* * *

Welcome to the surveillance society.  Every citizen has been scanned, chipped, folded, spindled and mutilated - and it's enough to make you scream.

Valley of Steel
A tale of the surveillance society by The Custodian of http://everything2.com
Release 1 / Serial number 130310 / Inform 7 build 6G60 (I6/v6.32 lib 6/12N) SD

Bedroom
Your bedroom is rather boring.  It contains your bed - currently unmade - and the usual assortment of bedroom furnishings including a bedside table, next to the bed.

On the bedside table are a watch and a phone.

You can go north and west from here.

>purloin knife and blue jacket
[Purloined.]
[Purloined.]

>remove tag with knife
You can't remove anything with that.

>remove tag
(first taking the blue jacket's antitheft tag)
What do you want to remove that with?

>wear watch
(first taking the watch)
You put on the watch.

* * *

Welcome to the surveillance society.  Every citizen has been scanned, chipped, folded, spindled and mutilated - and it's enough to make you scream.

Valley of Steel
A tale of the surveillance society by The Custodian of http://everything2.com
Release 1 / Serial number 130310 / Inform 7 build 6G60 (I6/v6.32 lib 6/12N) SD

Bedroom
Your bedroom is rather boring.  It contains your bed - currently unmade - and the usual assortment of bedroom furnishings including a bedside table, next to the bed.

On the bedside table are a watch and a phone.

You can go north and west from here.

>purloin axe
[Purloined.]

>smash bed
Violence isn't the answer to this one.

>gonear bouncelift vestibule
Bouncelift Vestibule
The service bouncelift opens onto a small vestibule, not much larger than the size of a closet.  A sign painted on the wall reads "LEVEL 35 - MEZZANINE". There is an automatic door with a palm lock to the east.

You can see Vestibule Door and a fire extinguisher here.

You can go east through Vestibule Door (closed) and west from here.

>smash door lock
What do you want to use to do that?

>smash door lock with axe
You heft the axe and set to.  The lock gives way before your furious assault!

>e
(first opening Vestibule Door)

Office Corridor
You are in the middle of a nondescript office corridor.  To the west is a security door to the service bouncelift.  To the north is a door reading "RESTROOM".  The corridor continues to the east.

You can see Vestibule Door here.

You can go north, east and west through Vestibule Door to the Bouncelift Vestibule from here.

There is a Public Surveillance Notice here.

Security surveillance spots you openly carrying a weapon.  Police rush in!

    *** You have been arrested! ***

Would you like to RESTART, RESTORE a saved game, QUIT or UNDO the last command?

>undo
Bouncelift Vestibule
[Previous turn undone.]

>drop axe
Dropped.

>e
(first opening Vestibule Door)

Office Corridor
You are in the middle of a nondescript office corridor.  To the west is a security door to the service bouncelift.  To the north is a door reading "RESTROOM".  The corridor continues to the east.

You can see Vestibule Door here.

You can go north, east and west through Vestibule Door to the Bouncelift Vestibule from here.

There is a Public Surveillance Notice here.

>e
Seating Area
The corridor ends in a small open seating area.  Through the windows the myriad internal windows of the spacescraper's other suites can be seen.  There is a door leading north, presumably to the rest of the office space.  It is closed and locked.  An observation window looks out east onto a ledge over the spacescraper's hollow core.

You can go east and west to Office Corridor from here.

There is a Public Surveillance Notice here.

>purloin tool
[Purloined.]

>smash window with tool
The multitool bounces off the tough armorcrys; you barely avoid injuring yourself.

>purloin descender and breaching charge
[Purloined.]
[Purloined.]

>e
The observation window is quite solid.  You can't walk through it.

>put breaching charge on window
You put the disarmed Breaching Charge on the observation window.

>arm charge
You pull the arming tab out and drop it, arming the Breaching Charge.
As soon as the charge detonates, the police will be looking at the surveillance video from this location; they'll ID you within a few minutes!

>w
Office Corridor
You are in the middle of a nondescript office corridor.  To the west is a security door to the service bouncelift.  To the north is a door reading "RESTROOM".  The corridor continues to the east.

You can see Vestibule Door here.

You can go north, east to Seating Area and west through Vestibule Door to the Bouncelift Vestibule from here.

There is a Public Surveillance Notice here.

>wear descender
You put on the descender.

>z
Time passes.

* * *

>z
Time passes.

There is a loud BOOM from nearby! The floor shakes.

>e
Seating Area
The corridor ends in a small open seating area.  Through the windows the myriad internal windows of the spacescraper's other suites can be seen.  There is a door leading north, presumably to the rest of the office space.  It is closed and locked.  The wreckage of an observation window leads east out to a ledge.

There are the unmistakable signs of an explosion.  Scarring and burn marks are everywhere, and a choking smell of residues hangs in the air.

You can go east and west to Office Corridor from here.

There is a Public Surveillance Notice here.

>z
Time passes.

>z
Time passes.

You're pretty sure the police saw you do that.  They'll be looking for you now.

>e
You step gingerly through the jagged hole in the observation window onto the ledge.

Atrium Ledge
This ledge, along with the others at the Mezzanine level, looks out over the huge hollow core of the Reserve Bank spacescraper's lower third.  The central column containing the main bouncelifts is visible perhaps fifty meters away.   Above, the roof of the atrium is hazily visible through the glare from its light fixtures some thirty floors up.  Sixty floors below, the main lobby can be made out.  To one side of the bouncelift column, the sublevel Lift Lobby can be seen one level below the lobby.  A very low glass wall surrounds the ledge for safety, but it's clear that this space isn't meant for the public.  A few holes in the plascrete floor hold scattered soil; one large planter in the center holds a scarred but defiantly unbent tree.

>attach cable to tree
(first taking the cable)
That seems to be a part of the descender.

* * *

Welcome to the surveillance society.  Every citizen has been scanned, chipped, folded, spindled and mutilated - and it's enough to make you scream.

Valley of Steel
A tale of the surveillance society by The Custodian of http://everything2.com
Release 1 / Serial number 130310 / Inform 7 build 6G60 (I6/v6.32 lib 6/12N) SD

Bedroom
Your bedroom is rather boring.  It contains your bed - currently unmade - and the usual assortment of bedroom furnishings including a bedside table, next to the bed.

On the bedside table are a watch and a phone.

You can go north and west from here.

>purloin blue jacket
[Purloined.]

>showme blue jacket
blue jacket - jacket
    blue jacket's antitheft tag (part of blue jacket) - antitheft tag
        memory chip - memory chip
location: carried by yourself in the Bedroom
singular-named, improper-named; unlit, inedible, portable, wearable, handled, assembled
printed name: "blue jacket"
printed plural name: "jackets"
indefinite article: none
description: "A dark blue jacket, very bland cut, with black snap closures and side pockets.  You almost expect to see a name sewn on the front at the breast in gold thread.  It's probably a size too large for you."
initial appearance: none
size: medium

>purloin tag remover
[Purloined.]

>remove blue jacket's antitheft tag with tag remover
You deftly remove the tag with the tag remover.

>showme blue jacket
blue jacket - jacket
location: carried by yourself in the Bedroom
singular-named, improper-named; unlit, inedible, portable, wearable, handled, assembled
printed name: "blue jacket"
printed plural name: "jackets"
indefinite article: none
description: "A dark blue jacket, very bland cut, with black snap closures and side pockets.  You almost expect to see a name sewn on the front at the breast in gold thread.  It's probably a size too large for you."
initial appearance: none
size: medium

>i
You are carrying:
  a blue jacket's antitheft tag
  a tag remover
  a blue jacket
  a backpack (being worn and open but empty)

>undo
Bedroom
[Previous turn undone.]

>i
You are carrying:
  a blue jacket's antitheft tag
  a tag remover
  a blue jacket
  a backpack (being worn and open but empty)

>showme blue jacket
blue jacket - jacket
location: carried by yourself in the Bedroom
singular-named, improper-named; unlit, inedible, portable, wearable, handled, assembled
printed name: "blue jacket"
printed plural name: "jackets"
indefinite article: none
description: "A dark blue jacket, very bland cut, with black snap closures and side pockets.  You almost expect to see a name sewn on the front at the breast in gold thread.  It's probably a size too large for you."
initial appearance: none
size: medium

>undo
Bedroom
[Previous turn undone.]

* * *

>i
You are carrying:
  a blue jacket's antitheft tag
  a tag remover
  a blue jacket
  a backpack (being worn and open but empty)

>restart
Are you sure you want to restart?

>yes
Welcome to the surveillance society.  Every citizen has been scanned, chipped, folded, spindled and mutilated - and it's enough to make you scream.

Valley of Steel
A tale of the surveillance society by The Custodian of http://everything2.com
Release 1 / Serial number 130310 / Inform 7 build 6G60 (I6/v6.32 lib 6/12N) SD

Bedroom
Your bedroom is rather boring.  It contains your bed - currently unmade - and the usual assortment of bedroom furnishings including a bedside table, next to the bed.

On the bedside table are a watch and a phone.

You can go north and west from here.

>purloin blue jacket
[Purloined.]

>i
You are carrying:
  a blue jacket
  a backpack (being worn and open but empty)

>x blue jaket
You can't see any such thing.

>x blue
(the blue jacket)
A dark blue jacket, very bland cut, with black snap closures and side pockets.  You almost expect to see a name sewn on the front at the breast in gold thread.  It's probably a size too large for you.

There is an antitheft tag attached to the blue jacket.

>cut antitheft tag
What do you want to cut that off with?

>cut antitheft tag with tag remover
I only understood you as far as wanting to cut the blue jacket's antitheft tag with the blue jacket's antitheft tag.

>cut antitheft tag with the tag remover
I only understood you as far as wanting to cut the blue jacket's antitheft tag with the blue jacket's antitheft tag.

>i
You are carrying:
  a blue jacket
  a backpack (being worn and open but empty)

>purloin tag remover
[Purloined.]

>cut antitheft tag with the tag remover
You deftly remove the tag with the tag remover.

>i
You are carrying:
  a blue jacket's antitheft tag
  a tag remover
  a blue jacket
  a backpack (being worn and open but empty)

* * *

>undo
Bedroom
[Previous turn undone.]

>i
You are carrying:
  a tag remover
  a blue jacket
  a backpack (being worn and open but empty)

>open antitheft tag
You don't have anything to open it with.

>purloin knife
[Purloined.]

>open antitheft tag
The tag is fastened to the blue jacket; you can't do that without damaging the garment.

>remove blue jacket's antitheft tag with tag remover
You deftly remove the tag with the tag remover.

>open antitheft tag
You cut open the antitheft tag with your knife.

You open the blue jacket's antitheft tag, revealing a memory chip.

>undo
Bedroom
[Previous turn undone.]

>cut antitheft tag
You cut open the antitheft tag with your knife.

You open the blue jacket's antitheft tag, revealing a memory chip.

>undo
Bedroom
[Previous turn undone.]

>drop knife
Dropped.

>open antitheft tat
I only understood you as far as wanting to open the blue jacket's antitheft tag.

>open antitheft tag
You don't have anything to open it with.

>cut antitheft tag
You don't have anything to cut that with.

>i
You are carrying:
  a blue jacket's antitheft tag
  a tag remover
  a blue jacket
  a backpack (being worn and open but empty)

>l
Bedroom
Your bedroom is rather boring.  It contains your bed - currently unmade - and the usual assortment of bedroom furnishings including a bedside table, next to the bed.

On the bedside table are a watch and a phone.

You can also see a lockblade knife here.

You can go north and west from here.

>take knife
This knife is large enough to run afoul of local weapons laws.  It would be a bad idea to let it be seen where the police are watching.

>cut antitheft tag
You cut open the antitheft tag with your knife.

You open the blue jacket's antitheft tag, revealing a memory chip.

* * *

Welcome to the surveillance society.  Every citizen has been scanned, chipped, folded, spindled and mutilated - and it's enough to make you scream.

Valley of Steel
A tale of the surveillance society by The Custodian of http://everything2.com
Release 1 / Serial number 130310 / Inform 7 build 6G60 (I6/v6.32 lib 6/12N) SD

Bedroom
Your bedroom is rather boring.  It contains your bed - currently unmade - and the usual assortment of bedroom furnishings including a bedside table, next to the bed.

On the bedside table are a watch and a phone.

You can go north and west from here.

>gonear fence
South Primrose Lane
Primrose Lane, just in front of your home.  To the south is a boarded-up empty house; sumac trees can be seen peeking over the top of the dilapidated fencing.  The fence has a plastic tarp strung behind it which prevents you from seeing much of the house.  To the west is a single-family home with a large burglar alarm warning sign and an enormous dog on the front lawn.  To the east is your building's front path.

You can go north and east from here.

>cut fence
What do you want to cut it with?

>cut fence with knife
You can't see any such thing.

>cut fence with tag remover
You can't see any such thing.

>purloin knife
[Purloined.]

>cut fence
What do you want to cut it with?

>actions
Actions listing on.

>cut fence
[cutting the fence]
What do you want to cut it with?
[cutting the fence - ended without result]

>cut fence with knife
[cutting the fence with the lockblade knife]
That won't cut cyclone fencing.
[cutting the fence with the lockblade knife - failed the Check cutting the fence with something]

>cut fence with tag remover
You can't see any such thing.

>purloin tag remover
[Purloined.]

>cut fence with tag remover
[cutting the fence with the tag remover]
You carefully cut through several strands of the fence until you have an opening big enough to slip through and slice a rent in the backing plastic.

Cutting that would achieve little.

[cutting the fence with the tag remover - succeeded]

* * *

>cut fence
What do you want to cut it with?

>cut fence with tag remover
You can't see any such thing.

>cut fence with knife
You can't see any such thing.

>purloin knife
[Purloined.]

>purloin multitool
[Purloined.]

>cut fence with multitool
That won't cut cyclone fencing.

>cut fence with knife
That won't cut cyclone fencing.

>pulroin tag remover
That's not a verb I recognize.

>purloin tag remover
[Purloined.]

>cut fence with tag remover
You carefully cut through several strands of the fence until you have an opening big enough to slip through and slice a rent in the backing plastic.

>undo
South Primrose Lane
[Previous turn undone.]

>rules
Rules tracing now switched on. Type "rules off" to switch it off again, or "rules all" to include even rules which do not apply.

>cut fence with tag remover
[Rule "Check cutting the fence with something" applies.]
[Rule "Check cutting it with" applies.]
[Rule "Carry out cutting the fence with the tag remover" applies.]
You carefully cut through several strands of the fence until you have an opening big enough to slip through and slice a rent in the backing plastic.

[Rule "Every Turn during Transit Stop" applies.]

>rules
Rules tracing now switched on. Type "rules off" to switch it off again, or "rules all" to include even rules which do not apply.

>purloin multitool
[Purloined.]

>cut fence with tool
[Rule "Check cutting the fence with something" applies.]
That won't cut cyclone fencing.

[Rule "Every Turn during Transit Stop" applies.]
[Rule "scene description text rule" applies.]

* * *

Welcome to the surveillance society.  Every citizen has been scanned, chipped, folded, spindled and mutilated - and it's enough to make you scream.

Valley of Steel
A tale of the surveillance society by The Custodian of http://everything2.com
Release 1 / Serial number 130310 / Inform 7 build 6G60 (I6/v6.32 lib 6/12N) SD

Bedroom
Your bedroom is rather boring.  It contains your bed - currently unmade - and the usual assortment of bedroom furnishings including a bedside table, next to the bed.

On the bedside table are a watch and a phone.

You can go north and west from here.

>gonear booking
Booking
This area is used for processing prisoners…er, excuse me, suspects, and as a waiting lounge.  There is a single hard bench, now empty, and a counter along the south wall with a stern poster on the wall above it.  One area has been kept clear and is a neutral pale blue, presumably to be used as a backdrop for photographing suspects.⁥猢瑥瀠潲潮湵⁳ￛ
"Unable to open s

You can see an ID camera here.

You can go north from here.

>l
Booking
This area is used for processing prisoners…er, excuse me, suspects, and as a waiting lounge.  There is a single hard bench, now empty, and a counter along the south wall with a stern poster on the wall above it.  One area has been kept clear and is a neutral pale blue, presumably to be used as a backdrop for photographing suspects.⁥猢瑥瀠潲潮湵⁳ￛ
"Unable to open s

You can see an ID camera here.

You can go north from here.

There is a Public Surveillance Notice here.

>l poster
If you see any DRUG ACTIVITY, report it AT ONCE to your FRIENDLY LOCAL POLICE.

>n
Front Desk
This is the front desk of the police station. A harried sergeant is manning the desk, and are so busy they don't even have time to give you more than a brief scowl.  To the north is a security gate leading into the police station proper, and to the south is an open area with a sign reading "BOOKING."

You can see Sergeant Ramirez here.

You can go south to Booking and east from here.

There is a Public Surveillance Notice here.

* * *

Welcome to the surveillance society.  Every citizen has been scanned, chipped, folded, spindled and mutilated - and it's enough to make you scream.

Valley of Steel
A tale of the surveillance society by The Custodian of http://everything2.com
Release 1 / Serial number 130310 / Inform 7 build 6G60 (I6/v6.32 lib 6/12N) SD

Bedroom
Your bedroom is rather boring.  It contains your bed - currently unmade - and the usual assortment of bedroom furnishings including a bedside table, next to the bed.

On the bedside table are a watch and a phone.

You can go north and west from here.

>purloin knife and tag remover
[Purloined.]
[Purloined.]

>gonear fence
South Primrose Lane
Primrose Lane, just in front of your home.  To the south is a boarded-up empty house; sumac trees can be seen peeking over the top of the dilapidated fencing.  The fence has a plastic tarp strung behind it which prevents you from seeing much of the house.  To the west is a single-family home with a large burglar alarm warning sign and an enormous dog on the front lawn.  To the east is your building's front path.

You can go north and east from here.

* * *

>cut fence
What do you want to cut it with?

>cut fence with knife
What do you want to cut it with?

>actions
Actions listing on.

>cut fence with knife
[cutting the fence with the lockblade knife]
What do you want to cut it with?

[cutting the fence with the lockblade knife - succeeded]

* * *

Welcome to the surveillance society.  Every citizen has been scanned, chipped, folded, spindled and mutilated - and it's enough to make you scream.

Valley of Steel
A tale of the surveillance society by The Custodian of http://everything2.com
Release 1 / Serial number 130310 / Inform 7 build 6G60 (I6/v6.32 lib 6/12N) SD

Bedroom
Your bedroom is rather boring.  It contains your bed - currently unmade - and the usual assortment of bedroom furnishings including a bedside table, next to the bed.

On the bedside table are a watch and a phone.

You can go north and west from here.

>gonear south primrose
Which do you mean, South Primrose or South Primrose Lane?

>gonear south primrose lane
South Primrose Lane
Primrose Lane, just in front of your home.  To the south is a boarded-up empty house; sumac trees can be seen peeking over the top of the dilapidated fencing.  The fence has a plastic tarp strung behind it which prevents you from seeing much of the house.  To the west is a single-family home with a large burglar alarm warning sign and an enormous dog on the front lawn.  To the east is your building's front path.

>l
South Primrose Lane
Primrose Lane, just in front of your home.  To the south is a boarded-up empty house; sumac trees can be seen peeking over the top of the dilapidated fencing.  The fence has a plastic tarp strung behind it which prevents you from seeing much of the house.  To the west is a single-family home with a large burglar alarm warning sign and an enormous dog on the front lawn.  To the east is your building's front path.

>l GRSpace
You can't see any such thing.

>l GRSpace
You can't see any such thing.

>l
South Primrose Lane
Primrose Lane, just in front of your home.  To the south is a boarded-up empty house; sumac trees can be seen peeking over the top of the dilapidated fencing.  The fence has a plastic tarp strung behind it which prevents you from seeing much of the house.  To the west is a single-family home with a large burglar alarm warning sign and an enormous dog on the front lawn.  To the east is your building's front path.

>showme GRSpace
GRSpace - backdrop
location: out of play
singular-named, proper-named; unlit, inedible, fixed in place, scenery, assembled
printed name: "GRSpace"
printed plural name: "backdrops"
indefinite article: none
description: "Far off to the west, the Reserve Bank spacescraper can be seen above the skyline."
initial appearance: none
size: medium

>showme GR Outdoors
GR Outdoors - region
singular-named, proper-named
printed name: "GR Outdoors"
printed plural name: "regions"
indefinite article: none

>e
Front Path
Your front path is paved with cracked flagstones, one of the few concessions to a sense of style that your absentee, never-to-be-seen landlord has made.  Primrose Lane is to the west, and your building is to the east.

You can see a mailbox (closed) here.

You can go east through the House door (closed) and west to South Primrose Lane from here.

>l
Front Path
Your front path is paved with cracked flagstones, one of the few concessions to a sense of style that your absentee, never-to-be-seen landlord has made.  Primrose Lane is to the west, and your building is to the east.

You can see a mailbox (closed) here.

You can go east through the House door (closed) and west to South Primrose Lane from here.

>l up
You see nothing unexpected in that direction.

>l GRSpace
Far off to the west, the Reserve Bank spacescraper can be seen above the skyline.