Welcome to the surveillance society.  Every citizen has been scanned, chipped, folded, spindled and mutilated - and it's enough to make you scream.

Valley of Steel
A tale of the surveillance society by The Custodian of http://everything2.com
Release 1 / Serial number 130218 / Inform 7 build 6G60 (I6/v6.32 lib 6/12N) SD

Bedroom
Your bedroom is rather boring.  It contains your bed - currently unmade - and the usual assortment of bedroom furnishings including a bedside table, next to the bed.

On the bedside table are a watch and a phone.

You can go north and west from here.

>wait 5 hours
It is now 5:00 pm.

>wait 5 hours
It is now 10:00 pm.

>wait 1 hours
It is now 11:00 pm.

>wait 55 minutes
It is now 11:55 pm.

>z
Time passes.

>actions
Actions listing on.

>wear watch
[wearing the watch]
(first taking the watch)
[(1) taking the watch - silently]
[(1) taking the watch - silently - succeeded]

You put on the watch.
[wearing the watch - succeeded]

>scenes
Scene 'Entire Game' playing (for 717 mins now)
Scene 'Roberto Drinking' ended
Scene 'Transit Stop' playing (for 1 mins now)
Scene 'Transit Enroute' ended
(Scene monitoring now switched on. Type "scenes off" to switch it off again.)

>z
[waiting]
Time passes.
[waiting - succeeded]

>z
[waiting]
Time passes.
[waiting - succeeded]

[Scene 'Transit Stop' ends]
[Scene 'Transit Enroute' begins]

>z
[waiting]
Time passes.
[waiting - succeeded]

>z
[waiting]
Time passes.
[waiting - succeeded]

>z
[waiting]
Time passes.
[waiting - succeeded]

[Scene 'Transit Enroute' ends]
[Scene 'Transit Stop' begins]

>z
[waiting]
Time passes.
[waiting - succeeded]

* * *

>z
[waiting]
Time passes.
[waiting - succeeded]

[Scene 'Transit Enroute' ends]
[Scene 'Transit Stop' begins]

>scenes
Scene 'Entire Game' playing (for -712 mins now)
Scene 'Roberto Drinking' ended
Scene 'Transit Stop' playing (for 0 mins now)
Scene 'Transit Enroute' ended
(Scene monitoring now switched on. Type "scenes off" to switch it off again.)

>scenes off
(Scene monitoring now switched off. Type "scenes" to switch it on again.)

>wait 5 hours
[waiting more 300]
It is now 5:08 am.
[waiting more 300 - succeeded]

>wait 5 hours
[waiting more 300]
It is now 10:08 am.
[waiting more 300 - succeeded]

>scenes
Scene 'Entire Game' playing (for -112 mins now)
Scene 'Roberto Drinking' ended
Scene 'Transit Stop' playing (for 0 mins now)
Scene 'Transit Enroute' ended
(Scene monitoring now switched on. Type "scenes off" to switch it off again.)

* * *

>wait 50 minutes
[waiting more 50]
[Scene 'Transit Stop' ends]
[Scene 'Transit Enroute' begins]
[Scene 'Transit Enroute' ends]
[Scene 'Transit Stop' begins]
[Scene 'Transit Stop' ends]
[Scene 'Transit Enroute' begins]
[Scene 'Transit Enroute' ends]
[Scene 'Transit Stop' begins]
[Scene 'Transit Stop' ends]
[Scene 'Transit Enroute' begins]
[Scene 'Transit Enroute' ends]
[Scene 'Transit Stop' begins]
[Scene 'Transit Stop' ends]
[Scene 'Transit Enroute' begins]
[Scene 'Transit Enroute' ends]
[Scene 'Transit Stop' begins]
[Scene 'Transit Stop' ends]
[Scene 'Transit Enroute' begins]
[Scene 'Transit Enroute' ends]
[Scene 'Transit Stop' begins]
[Scene 'Transit Stop' ends]
[Scene 'Transit Enroute' begins]
[Scene 'Transit Enroute' ends]
[Scene 'Transit Stop' begins]
[Scene 'Transit Stop' ends]
[Scene 'Transit Enroute' begins]
[Scene 'Transit Enroute' ends]
[Scene 'Transit Stop' begins]
[Scene 'Transit Stop' ends]
[Scene 'Transit Enroute' begins]
[Scene 'Transit Enroute' ends]
[Scene 'Transit Stop' begins]
It is now 1:58 pm.
[waiting more 50 - succeeded]

>z
[waiting]
Time passes.
[waiting - succeeded]

[Scene 'Transit Stop' ends]
[Scene 'Transit Enroute' begins]

* * *

>z
[waiting]
Time passes.
[waiting - succeeded]

>z
[waiting]
Time passes.
[waiting - succeeded]

[Scene 'Roberto Drinking' begins]

>gonear proletariat bar
[(1) looking]
Proletariat Bar
The Proletariat is a local bar (not a pub).  It's just far enough above a "dive" to be allowed zoning here, but steadfastedly refuses to cater to upscale tastes.  You like it.  Restrooms are to the east; the bar runs along the north side, a jukebox sits against the back wall, and the rest of the space is filled with bar tables.  A few hardy drinkers sit here, communing with their spirits.  In a nod to the place's name, a Public Surveillance Notice covered with stickers and graffiti tags has been framed above the bar.

You can see Roberto Velez here.

You can go northwest, southwest, east and west from here.

[(1) looking - succeeded]

>actions off
Actions listing off.

>scenes off
(Scene monitoring now switched off. Type "scenes" to switch it on again.)

>purloin tissue sampler
[Purloined.]

>showme tissue samlper
There seems to be no such object anywhere in the model world.

>showme tissue sampler
tissue sampler - thing
location: carried by yourself in the Proletariat Bar
singular-named, improper-named; unlit, inedible, portable, handled, assembled
printed name: "tissue sampler"
printed plural name: none
indefinite article: none
description: "This is a tissue sampler, used by hospital and emergency medical technicians for scanning skin or tissue in order to permit a tissue generator to produce compatible skin grafts. It is flat and translucent, and is intended to be laid against the skin to be replicated."
initial appearance: none
size: medium
tissueDonor: "blank"

>w
Green Commercial Plaza Center
This is the center of the Green Commercial Plaza.  There is a fountain here with a pair of benches facing it.  The plaza continues to the north and south; to the east is a bar called (ironically, you hope) the Proletariat.  To the west is a Bistro Paris cafe.

You can see a trash can (closed) here.

You can go north, northeast, northwest, south, southeast, east to the Proletariat Bar and west from here.

There is a Public Surveillance Notice here.

>nw
The Bank
This is a completely nondescript bank storefront which exists solely to house an ATM.  It's so nondescript, in fact, you can't even really tell which bank owns it, probably to ensure that they can charge you access fees no matter what.  To the east is Green Commercial Plaza.

You can see an ATM here.

You can go southeast to Green Commercial Plaza Center and east from here.

There is a Public Surveillance Notice here.

>l ATM
This is a standard ATM, using palm prints or Mit-Klein authentication to permit customers to perform banking transactions. A palm reader juts out from the front of the console.

The ATM is currently switched off.

>l palm reader
This is a standard palm reader, which is used to verify the identity of the ATM customer.  A flat plate, slightly inset, it is placed at a convenient angle to allow the palm to lie  against it.

* * *

Welcome to the surveillance society.  Every citizen has been scanned, chipped, folded, spindled and mutilated - and it's enough to make you scream.

Valley of Steel
A tale of the surveillance society by The Custodian of http://everything2.com
Release 1 / Serial number 130218 / Inform 7 build 6G60 (I6/v6.32 lib 6/12N) SD

Bedroom
Your bedroom is rather boring.  It contains your bed - currently unmade - and the usual assortment of bedroom furnishings including a bedside table, next to the bed.

On the bedside table are a watch and a phone.

You can go north and west from here.

>gonear atm
The Bank
This is a completely nondescript bank storefront which exists solely to house an ATM.  It's so nondescript, in fact, you can't even really tell which bank owns it, probably to ensure that they can charge you access fees no matter what.  To the east is Green Commercial Plaza.

You can see an ATM here.

You can go southeast and east from here.

>use the atm
How would you like to use the ATM?

>switch on the atm
The palm reader appears to be broken; it does not respond.

>purloin tissue sampler
[Purloined.]

>put tissue sampler in palm reader
You carefully fit the tissue sampler into the hollow of the palm reader so that it lies over the read area.

>switch on the atm
You start to reach out to use the ATM, but the machine is unable to contact your MitKlein Encapsulation.  It flashes a red light and shuts off.

* * *

>gonear atm
The Bank
This is a completely nondescript bank storefront which exists solely to house an ATM.  It's so nondescript, in fact, you can't even really tell which bank owns it, probably to ensure that they can charge you access fees no matter what.  To the east is Green Commercial Plaza.

You can see an ATM here.

You can go southeast and east from here.

>actions
Actions listing on.

>rules
Rules tracing now switched on. Type "rules off" to switch it off again, or "rules all" to include even rules which do not apply.

>use atm
How would you like to use the ATM?

>switch on atm
[switching on the ATM]
[Rule "Instead of switching on the ATM" applies.]
The palm reader appears to be broken; it does not respond.
[switching on the ATM - ended without result]

>purloin tissue sampler
[Purloined.]

>put sampler in palm reader
[inserting the tissue sampler into the palm reader]
[Rule "Instead of inserting into the palm reader" applies.]
You carefully fit the tissue sampler into the hollow of the palm reader so that it lies over the read area.
[inserting the tissue sampler into the palm reader - failed]

[Rule "scene description text rule" applies.]

>switch on atm
[switching on the ATM]
[Rule "Instead of switching on the ATM" applies.]
You start to reach out to use the ATM, but the machine is unable to contact your MitKlein Encapsulation.  It flashes a red light and shuts off.
[switching on the ATM - ended without result]

[Rule "Every Turn during Transit Stop" applies.]

* * *

>gonear atm
The Bank
This is a completely nondescript bank storefront which exists solely to house an ATM.  It's so nondescript, in fact, you can't even really tell which bank owns it, probably to ensure that they can charge you access fees no matter what.  To the east is Green Commercial Plaza.

You can see an ATM here.

You can go southeast and east from here.

>use atm
(on the backpack)
How would you like to use the ATM?

* * *

>gonear atm
The Bank
This is a completely nondescript bank storefront which exists solely to house an ATM.  It's so nondescript, in fact, you can't even really tell which bank owns it, probably to ensure that they can charge you access fees no matter what.  To the east is Green Commercial Plaza.

You can see an ATM here.

You can go southeast and east from here.

>user atm
That's not a verb I recognize.

>use atm
How would you like to use the ATM?

>actions
Actions listing on.

>use atm
How would you like to use the ATM?

* * *

Welcome to the surveillance society.  Every citizen has been scanned, chipped, folded, spindled and mutilated - and it's enough to make you scream.

Valley of Steel
A tale of the surveillance society by The Custodian of http://everything2.com
Release 1 / Serial number 130218 / Inform 7 build 6G60 (I6/v6.32 lib 6/12N) SD

Bedroom
Your bedroom is rather boring.  It contains your bed - currently unmade - and the usual assortment of bedroom furnishings including a bedside table, next to the bed.

On the bedside table are a watch and a phone.

You can go north and west from here.

>wear watch
(first taking the watch)
You put on the watch.

>take phone
Taken.

>w
Hall
The central hallway of your modest home.  It's relatively clean and neat, as there is no furniture in it.

You can go north, east to the Bedroom and west from here.

>n
Entry
This is the small entryway to your apartment. A pile of mail, most of it unread, covers the small table just inside your front door.  The apartment hallway is to the south.  To the west is your office, and to the east is your bathroom.

You can see a side table (on which is a car key) here.

You can go north through the Front door (closed), south to the Hall, east and west from here.

>take key
Taken.

>w
Home Office
Your home office, a room which in other homes might be a living room, is not very tidy.  Books, random equipment and empty soda cans cover most available surfaces except for your workbench and your laptop.

You can see a workbench (on which are a multitool, a lockblade knife, a soldering iron, some solder and a laptop) here.

You can go south and east to Entry from here.

>take tool
Taken.

>gonear proletariat restroom
Proletariat restroom
The one-holer restroom at the Proletariat is cleaner than you might think, although that may be due to the fact that it is midweek.  A scratched mirror over the sink has been covered with marker graffiti.

You can see a Proletariat trash can (closed) here.

You can go west from here.

>l trash
(the Proletariat trash can)
Painted industrial dark green, the Proletariat restroom trash can awaits its daily diet of rubbish.  There is a solar panel on it; presumably it reports back to a central system when it is full.

>l panel
A small (8x8cm) solar panel set into the lid, apparently powering something embedded in the trash can.

>open panel
You pry open the solar panel with the multitool, ignoring the cracking sounds.

You open the Proletariat trash can's solar panel, revealing a broadcast chip.

>l in panel
In the Proletariat trash can's solar panel is a broadcast chip.

>l
Proletariat restroom
The one-holer restroom at the Proletariat is cleaner than you might think, although that may be due to the fact that it is midweek.  A scratched mirror over the sink has been covered with marker graffiti.

You can see a Proletariat trash can (closed) here.

You can go west from here.

>l can
Painted industrial dark green, the Proletariat restroom trash can awaits its daily diet of rubbish.  There is a solar panel on it; presumably it reports back to a central system when it is full.  The solar panel on the can lid has been pried back.  Vandals!

>l panel
A small (8x8cm) solar panel set into the lid, apparently powering something embedded in the trash can.  This one has been pried back.

In the Proletariat trash can's solar panel is a broadcast chip.

>take broadcast
Taken.

>l
Proletariat restroom
The one-holer restroom at the Proletariat is cleaner than you might think, although that may be due to the fact that it is midweek.  A scratched mirror over the sink has been covered with marker graffiti.

You can see a Proletariat trash can (closed) here.

You can go west from here.

>l trash
(the Proletariat trash can)
Painted industrial dark green, the Proletariat restroom trash can awaits its daily diet of rubbish.  There is a solar panel on it; presumably it reports back to a central system when it is full.  The solar panel on the can lid has been pried back.  Vandals!

>l panel
A small (8x8cm) solar panel set into the lid, apparently powering something embedded in the trash can.  This one has been pried back.

>l in panel
The Proletariat trash can's solar panel is empty.

>w
Proletariat Bar
The Proletariat is a local bar (not a pub).  It's just far enough above a "dive" to be allowed zoning here, but steadfastedly refuses to cater to upscale tastes.  You like it.  Restrooms are to the east; the bar runs along the north side, a jukebox sits against the back wall, and the rest of the space is filled with bar tables.  A few hardy drinkers sit here, communing with their spirits.  In a nod to the place's name, a Public Surveillance Notice covered with stickers and graffiti tags has been framed above the bar.

You can go northwest, southwest, east to the Proletariat restroom and west from here.

>w
Green Commercial Plaza Center
This is the center of the Green Commercial Plaza.  There is a fountain here with a pair of benches facing it.  The plaza continues to the north and south; to the east is a bar called (ironically, you hope) the Proletariat.  To the west is a Bistro Paris cafe.

You can see a trash can (closed) here.

You can go north, northeast, northwest, south, southeast, east to the Proletariat Bar and west from here.

There is a Public Surveillance Notice here.

>l trash can
Painted industrial dark green, the Green Commercial Plaza Center trash can awaits its daily diet of rubbish.  There is a solar panel on it; presumably it reports back to a central system when it is full.

>open panel
You pry open the solar panel with the multitool, ignoring the cracking sounds.

You open the solar panel, revealing a broadcast chip.

>l
Green Commercial Plaza Center
This is the center of the Green Commercial Plaza.  There is a fountain here with a pair of benches facing it.  The plaza continues to the north and south; to the east is a bar called (ironically, you hope) the Proletariat.  To the west is a Bistro Paris cafe.

You can see a trash can (closed) here.

You can go north, northeast, northwest, south, southeast, east to the Proletariat Bar and west from here.

There is a Public Surveillance Notice here.

>l trash can
Painted industrial dark green, the Green Commercial Plaza Center trash can awaits its daily diet of rubbish.  There is a solar panel on it; presumably it reports back to a central system when it is full.  The solar panel on the can lid has been pried back.  Vandals!

>take panel
That seems to be a part of the trash can.

>take broadcast
Taken.

>l
Green Commercial Plaza Center
This is the center of the Green Commercial Plaza.  There is a fountain here with a pair of benches facing it.  The plaza continues to the north and south; to the east is a bar called (ironically, you hope) the Proletariat.  To the west is a Bistro Paris cafe.

You can see a trash can (closed) here.

You can go north, northeast, northwest, south, southeast, east to the Proletariat Bar and west from here.

There is a Public Surveillance Notice here.

>showme player
There seems to be no such object anywhere in the model world.

>showme me
yourself - person
    your palm (part of yourself) - palm
    your eye (part of yourself) - eye
    MitKlein (part of yourself)
    broadcast chip - broadcast chip
    broadcast chip - broadcast chip
    multitool
    car key - closed container
        broadcast chip - broadcast chip
        memory chip - memory chip
    phone
    watch (worn)
    backpack (worn) - player's holdall
location: in Green Commercial Plaza Center
singular-named, proper-named; unlit, inedible, portable, assembled; male
printed name: "yourself"
printed plural name: "people"
indefinite article: none
description: "As good-looking as ever."
initial appearance: none
size: medium
carrying capacity: 5
suspicionState: clear

>showme Green Commercial Plaza Center
Green Commercial Plaza Center - room
    Public Surveillance Notice - backdrop
    yourself - person
        your palm (part of yourself) - palm
        your eye (part of yourself) - eye
        MitKlein (part of yourself)
        broadcast chip - broadcast chip
        broadcast chip - broadcast chip
        multitool
        car key - closed container
            *broadcast chip - broadcast chip
            *memory chip - memory chip
        phone
        watch (worn)
        backpack (worn) - player's holdall
    trash can - trash can
        solar panel (part of trash can) - solar panel
        *rubbish - rubbish
* denotes things which are not in scope
singular-named, proper-named; lighted, visited, panopticon, safe, mapped
printed name: "Green Commercial Plaza Center"
printed plural name: none
indefinite article: none
description: "This is the center of the Green Commercial Plaza.  There is a fountain here with a pair of benches facing it.  The plaza continues to the north and south; to the east is a bar called (ironically, you hope) the Proletariat.  To the west is a Bistro Paris cafe."

>restart
Are you sure you want to restart?

>yes
Welcome to the surveillance society.  Every citizen has been scanned, chipped, folded, spindled and mutilated - and it's enough to make you scream.

Valley of Steel
A tale of the surveillance society by The Custodian of http://everything2.com
Release 1 / Serial number 130218 / Inform 7 build 6G60 (I6/v6.32 lib 6/12N) SD

Bedroom
Your bedroom is rather boring.  It contains your bed - currently unmade - and the usual assortment of bedroom furnishings including a bedside table, next to the bed.

On the bedside table are a watch and a phone.

You can go north and west from here.

>gonear green commercial plaza center
Green Commercial Plaza Center
This is the center of the Green Commercial Plaza.  There is a fountain here with a pair of benches facing it.  The plaza continues to the north and south; to the east is a bar called (ironically, you hope) the Proletariat.  To the west is a Bistro Paris cafe.

You can see a trash can (closed) here.

You can go north, northeast, northwest, south, southeast, east and west from here.

>actions
Actions listing on.

* * *

>rules
Rules tracing now switched on. Type "rules off" to switch it off again, or "rules all" to include even rules which do not apply.

>purloin tool
[Purloined.]

>l trash
[examining the trash can]
[Rule "standard examining rule" applies.]
Painted industrial dark green, the Green Commercial Plaza Center trash can awaits its daily diet of rubbish.  There is a solar panel on it; presumably it reports back to a central system when it is full.

[Rule "examine directions rule" applies.]
[Rule "examine containers rule" applies.]
[Rule "examine supporters rule" applies.]
[Rule "examine devices rule" applies.]
[Rule "examine undescribed things rule" applies.]
[Rule "report other people examining rule" applies.]
[examining the trash can - succeeded]

>l panel
[examining the solar panel]
[Rule "standard examining rule" applies.]
A small (8x8cm) solar panel set into the lid, apparently powering something embedded in the trash can.

[Rule "examine directions rule" applies.]
[Rule "examine containers rule" applies.]
[Rule "examine supporters rule" applies.]
[Rule "examine devices rule" applies.]
[Rule "examine undescribed things rule" applies.]
[Rule "report other people examining rule" applies.]
[examining the solar panel - succeeded]

>open panel
[opening the solar panel]
[Rule "Check opening a solar panel" applies.]
You pry open the solar panel with the multitool, ignoring the cracking sounds.

[Rule "can't open unless openable rule" applies.]
[Rule "can't open what's locked rule" applies.]
[Rule "can't open what's already open rule" applies.]
[Rule "standard opening rule" applies.]
[Rule "reveal any newly visible interior rule" applies.]
You open the solar panel, revealing a broadcast chip.
[opening the solar panel - succeeded]

* * *

Welcome to the surveillance society.  Every citizen has been scanned, chipped, folded, spindled and mutilated - and it's enough to make you scream.

Valley of Steel
A tale of the surveillance society by The Custodian of http://everything2.com
Release 1 / Serial number 130218 / Inform 7 build 6G60 (I6/v6.32 lib 6/12N) SD

Bedroom
Your bedroom is rather boring.  It contains your bed - currently unmade - and the usual assortment of bedroom furnishings including a bedside table, next to the bed.

On the bedside table are a watch and a phone.

You can go north and west from here.

>actions
Actions listing on.

>purloin jacket
Which do you mean, the torn jacket, the blue jacket or the red jacket?

>purloin torn jacket
[Purloined.]

>actions
Actions listing on.

>take nametag
[taking the nametag]
You aren't holding the jacket.
[taking the nametag - failed]

>remove nametag
[taking off the nametag]
(first taking the nametag)
[(1) taking the nametag - silently]
You aren't holding the jacket.
[(1) taking the nametag - silently - failed]
[taking off the nametag - failed]

>remove jacket
[taking off the torn jacket]
You take off the torn jacket.
[taking off the torn jacket - succeeded]

>take nametag
[taking the nametag]
You remove the nametag.

That seems to be a part of the torn jacket.
[taking the nametag - failed]

>showme nametag
nametag - thing
location: part of the torn jacket carried by yourself in the Bedroom
singular-named, improper-named; unlit, inedible, fixed in place, scenery, assembled
printed name: "nametag"
printed plural name: none
indefinite article: none
description: "A small black nametag with the name "Roberto Velez" inscribed on it."
initial appearance: none
size: small

>take off ametag
You can't see any such thing.

>take off nametag
[taking off the nametag]
(first taking the nametag)
[(1) taking the nametag - silently]
You remove the nametag.

That seems to be a part of the torn jacket.
[(1) taking the nametag - silently - failed]
[taking off the nametag - failed]

>purloin tissue sampler
[Purloined.]

* * *

>rules
Rules tracing now switched on. Type "rules off" to switch it off again, or "rules all" to include even rules which do not apply.

>gonear atm
[Rule "determine visibility ceiling rule" applies.]
[(1) looking]
[Rule "room description heading rule" applies.]
The Bank
[Rule "room description body text rule" applies.]
This is a completely nondescript bank storefront which exists solely to house an ATM.  It's so nondescript, in fact, you can't even really tell which bank owns it, probably to ensure that they can charge you access fees no matter what.  To the east is Green Commercial Plaza.

[Rule "room description paragraphs about objects rule" applies.]
[Rule "don't mention player's supporter in room descriptions rule" applies.]
[Rule "don't mention scenery in room descriptions rule" applies.]
[Rule "don't mention undescribed items in room descriptions rule" applies.]
[Rule "set pronouns from items in room descriptions rule" applies.]
[Rule "offer items to writing a paragraph about rule" applies.]
[Rule "use initial appearance in room descriptions rule" applies.]
[Rule "describe what's on scenery supporters in room descriptions rule" applies.]
[Rule "don't mention player's supporter in room descriptions rule" applies.]
[Rule "don't mention scenery in room descriptions rule" applies.]
[Rule "don't mention undescribed items in room descriptions rule" applies.]
[Rule "set pronouns from items in room descriptions rule" applies.]
[Rule "offer items to writing a paragraph about rule" applies.]
[Rule "use initial appearance in room descriptions rule" applies.]
[Rule "describe what's on scenery supporters in room descriptions rule" applies.]
[Rule "don't mention player's supporter in room descriptions rule" applies.]
[Rule "don't mention scenery in room descriptions rule" applies.]
[Rule "don't mention undescribed items in room descriptions rule" applies.]
[Rule "set pronouns from items in room descriptions rule" applies.]
[Rule "offer items to writing a paragraph about rule" applies.]
[Rule "use initial appearance in room descriptions rule" applies.]
[Rule "describe what's on scenery supporters in room descriptions rule" applies.]
You can see an ATM here.

[Rule "check new arrival rule" applies.]
[Rule "exits rule" applies.]
[Rule "darkness hides exits rule" applies.]
[Rule "darkness hides exits rule" applies.]
You can go [Rule "darkness hides exits rule" applies.]
[Rule "darkness hides exits rule" applies.]
southeast and east from here.

[Rule "other people looking rule" applies.]
[(1) looking - succeeded]

>use the atm
How would you like to use the ATM?

>use atm
How would you like to use the ATM?

>switch on the atm
[switching on the ATM]
[Rule "Instead of switching on the ATM" applies.]
The palm reader appears to be broken; it does not respond.
[switching on the ATM - ended without result]

* * *

>actions
Actions listing on.

>gonear atm
[(1) looking]
The Bank
This is a completely nondescript bank storefront which exists solely to house an ATM.  It's so nondescript, in fact, you can't even really tell which bank owns it, probably to ensure that they can charge you access fees no matter what.  To the east is Green Commercial Plaza.

You can see an ATM here.

You can go southeast and east from here.

[(1) looking - succeeded]

>use atm
How would you like to use the ATM?

>rules
Rules tracing now switched on. Type "rules off" to switch it off again, or "rules all" to include even rules which do not apply.

* * *

>use atm
How would you like to use the ATM?

>use the atm
How would you like to use the ATM?

* * *

Welcome to the surveillance society.  Every citizen has been scanned, chipped, folded, spindled and mutilated - and it's enough to make you scream.

Valley of Steel
A tale of the surveillance society by The Custodian of http://everything2.com
Release 1 / Serial number 130218 / Inform 7 build 6G60 (I6/v6.32 lib 6/12N) SD

Bedroom
Your bedroom is rather boring.  It contains your bed - currently unmade - and the usual assortment of bedroom furnishings including a bedside table, next to the bed.

On the bedside table are a watch and a phone.

You can go north and west from here.

>gonear proletariat bar
Proletariat Bar
The Proletariat is a local bar (not a pub).  It's just far enough above a "dive" to be allowed zoning here, but steadfastedly refuses to cater to upscale tastes.  You like it.  Restrooms are to the east; the bar runs along the north side, a jukebox sits against the back wall, and the rest of the space is filled with bar tables.  A few hardy drinkers sit here, communing with their spirits.  In a nod to the place's name, a Public Surveillance Notice covered with stickers and graffiti tags has been framed above the bar.

You can go northwest, southwest, east and west from here.

>purloin blue jacket
[Purloined.]

>wait 2 hours
It is now 2:00 pm.

>z
Time passes.

The door opens.  A medium man in a blue trade uniform comes in, orders a beer and sits down at a table.

>l man
You can't see any such thing.

* * *

Welcome to the surveillance society.  Every citizen has been scanned, chipped, folded, spindled and mutilated - and it's enough to make you scream.

Valley of Steel
A tale of the surveillance society by The Custodian of http://everything2.com
Release 1 / Serial number 130218 / Inform 7 build 6G60 (I6/v6.32 lib 6/12N) SD

Bedroom
Your bedroom is rather boring.  It contains your bed - currently unmade - and the usual assortment of bedroom furnishings including a bedside table, next to the bed.

On the bedside table are a watch and a phone.

You can go north and west from here.

>purloin blue jacket
[Purloined.]

>purloin tissue sampler
[Purloined.]

>gonear atm
The Bank
This is a completely nondescript bank storefront which exists solely to house an ATM.  It's so nondescript, in fact, you can't even really tell which bank owns it, probably to ensure that they can charge you access fees no matter what.  To the east is Green Commercial Plaza.

You can go southeast and east from here.

>l atm
This is a standard ATM, using palm prints or Mit-Klein authentication to permit customers to perform banking transactions. A palm reader juts out from the front of the console.

>use atm
How would you like to use the ATM?

* * *

>purloin blue jacket
[Purloined.]

>purloin tag remover
[Purloined.]

>cut tag
(the tag remover)
Cutting that up would achieve little.

>remove tag
(the tag remover)
You're not wearing that.

>remove antitheft tag
(first taking the blue jacket's antitheft tag)
What do you want to remove that with?

>remove antitheft tag with tag remover
You deftly remove the tag with the tag remover.

>wait 2 hours
It is now 2:04 pm.

>z
Time passes.

>z
Time passes.

>l
Bedroom
Your bedroom is rather boring.  It contains your bed - currently unmade - and the usual assortment of bedroom furnishings including a bedside table, next to the bed.

On the bedside table are a watch and a phone.

You can go north and west from here.

>z
Time passes.

>gonear the proletariat bar
Proletariat Bar
The Proletariat is a local bar (not a pub).  It's just far enough above a "dive" to be allowed zoning here, but steadfastedly refuses to cater to upscale tastes.  You like it.  Restrooms are to the east; the bar runs along the north side, a jukebox sits against the back wall, and the rest of the space is filled with bar tables.  A few hardy drinkers sit here, communing with their spirits.  In a nod to the place's name, a Public Surveillance Notice covered with stickers and graffiti tags has been framed above the bar.

You can see Roberto Velez here.

You can go northwest, southwest, east and west from here.

>roberto, tell me about your job
Roberto sighs.  "I have a good job," he says.  "I am a custodian at the Reserve Bank, downtown.  The work is not bad, and the pay is not terrible, but they are very strict about the uniform."

>roberto, tell me about your uniform
Roberto cranes his head to look at the damage.  "Oh, yes," he says.  "This happened at work.  I caught it on a shelf."  He shakes his head dolefully.  "They are making me pay for the jacket," he says to you, "but they are charging me the new price for it!  The price, it is ridiculous!  I would replace it myself but I cannot afford one like it.  I will have to let them dock my pay for months."

>offer blue jacket to roberto
(Roberto Velez)
Roberto stands up and eagerly examines the blue jacket.  "This is perfect!" he says enthusiastically, showing you how closely it resembles his torn uniform jacket.  "Would you be willing to part with it? I cannot give you much, but I would happily pay you what I can; it will be less than what those dogs would take from my salary to replace this one!"

Roberto Velez goes northwest.

>nw
Green Commercial Plaza North
Green Commercial One is built around a plaza, and this is its northern end.  No vehicles are permitted within the public areas of Green Commercial One, so the entire area is pedestrian-only.  To the north are the doors to the Green Commercial Station.  To the east is the NanoMart.  To the west is a storefront bank with an ATM.  The plaza continues to the south.

You can see Roberto Velez and a trash can (closed) here.

You can go north, south, southeast to the Proletariat Bar, southwest, east and west from here.

There is a Public Surveillance Notice here.

Roberto Velez goes west.

>w
The Bank
This is a completely nondescript bank storefront which exists solely to house an ATM.  It's so nondescript, in fact, you can't even really tell which bank owns it, probably to ensure that they can charge you access fees no matter what.  To the east is Green Commercial Plaza.

You can see Roberto Velez and an ATM here.

You can go southeast and east to Green Commercial Plaza North from here.

There is a Public Surveillance Notice here.

Roberto approaches the ATM, intent on withdrawing funds to pay you for the blue jacket.
He looks at the ATM, then at you.  "The ATM scanner, he is broken."  He shakes his head.

>purloin tissue scanner
There seems to be no such object anywhere in the model world.

>purloin tissue sampler
[Purloined.]

>put sampler in atm
That can't contain things.

>put sampler in palm reader
You carefully fit the tissue sampler into the hollow of the palm reader so that it lies over the read area.

Roberto approaches the ATM, intent on withdrawing funds to pay you for the blue jacket.
Roberto places his palm on the sampler, hidden inside the ATM.  It flashes briefly.  Nothing else happens.
He shakes his head.  "I am sorry, but the machine is broken."  You reassure him that you don't need paying for the jacket, at which he breaks out into a huge smile, gives you a hug, shakes your hand and quickly changes into the new blue jacket, dropping his torn jacket.  He walks out of the ATM, proudly fingering his new wardrobe.

I beg your pardon?

>z
Time passes.

>scenes
Scene 'Entire Game' playing (for 136 mins now)
Scene 'Bank Run' ended
Scene 'Getting Cash' ended successfully
Scene 'Roberto Waiting' ended in retry
Scene 'Roberto Drinking' ended
Scene 'Transit Stop' playing (for 2 mins now)
Scene 'Transit Enroute' ended
(Scene monitoring now switched on. Type "scenes off" to switch it off again.)

>showme tissue sampler
tissue sampler (Roberto) - thing
location: in the palm reader , which is part of the ATM in The Bank
singular-named, improper-named; unlit, inedible, portable, handled, assembled
printed name: "tissue sampler (Roberto)"
printed plural name: none
indefinite article: none
description: "This is a tissue sampler, used by hospital and emergency medical technicians for scanning skin or tissue in order to permit a tissue generator to produce compatible skin grafts. It is flat and translucent, and is intended to be laid against the skin to be replicated."
initial appearance: none
size: medium
tissueDonor: "Roberto"

>showme blue jacket
blue jacket - jacket
    nametag (part of blue jacket)
location: worn by Roberto Velez out of play
singular-named, improper-named; unlit, inedible, portable, wearable, handled, assembled
printed name: "blue jacket"
printed plural name: "jackets"
indefinite article: none
description: "A dark blue jacket, very bland cut.  You almost expect to see a name sewn on the front at the breast in gold thread.  It's probably three sizes too large for you."
initial appearance: none
size: medium

>l
The Bank
This is a completely nondescript bank storefront which exists solely to house an ATM.  It's so nondescript, in fact, you can't even really tell which bank owns it, probably to ensure that they can charge you access fees no matter what.  To the east is Green Commercial Plaza.

You can see a torn jacket and an ATM here.

You can go southeast and east to Green Commercial Plaza North from here.

There is a Public Surveillance Notice here.

>take torn jacket
Taken.

>wear torn jacket
You put on the torn jacket.

[Scene 'Transit Stop' ends]
[Scene 'Transit Enroute' begins]

>purloin watch
[Purloined.]

>wear watch
You put on the watch.

>gonear the proletariat bar
Proletariat Bar
The Proletariat is a local bar (not a pub).  It's just far enough above a "dive" to be allowed zoning here, but steadfastedly refuses to cater to upscale tastes.  You like it.  Restrooms are to the east; the bar runs along the north side, a jukebox sits against the back wall, and the rest of the space is filled with bar tables.  A few hardy drinkers sit here, communing with their spirits.  In a nod to the place's name, a Public Surveillance Notice covered with stickers and graffiti tags has been framed above the bar.

You can go northwest to Green Commercial Plaza North, southwest, east and west from here.

>scenes
Scene 'Entire Game' playing (for 138 mins now)
Scene 'Bank Run' ended
Scene 'Getting Cash' ended successfully
Scene 'Roberto Waiting' ended in retry
Scene 'Roberto Drinking' ended
Scene 'Transit Stop' ended
Scene 'Transit Enroute' playing (for 1 mins now)
(Scene monitoring now switched on. Type "scenes off" to switch it off again.)

>wait 24 hours
You really haven't got that kind of patience.

>wait 10 hours
You really haven't got that kind of patience.

[Scene 'Transit Enroute' ends]
[Scene 'Transit Stop' begins]

* * *

I beg your pardon?

I beg your pardon?

* * *

Welcome to the surveillance society.  Every citizen has been scanned, chipped, folded, spindled and mutilated - and it's enough to make you scream.

Valley of Steel
A tale of the surveillance society by The Custodian of http://everything2.com
Release 1 / Serial number 130218 / Inform 7 build 6G60 (I6/v6.32 lib 6/12N) SD

Bedroom
Your bedroom is rather boring.  It contains your bed - currently unmade - and the usual assortment of bedroom furnishings including a bedside table, next to the bed.

On the bedside table are a watch and a phone.

You can go north and west from here.

>get phone
Taken.

>l phone
Your cell phone was a standard candybar model with a nice screen.  "Was" because apparently, in your paranoia-fueled hacking binge, you must have decided it was too easy for the government to spy on you through it, and done something about that.  Now it's dead.  The screen is black.

* * *

Welcome to the surveillance society.  Every citizen has been scanned, chipped, folded, spindled and mutilated - and it's enough to make you scream.

Valley of Steel
A tale of the surveillance society by The Custodian of http://everything2.com
Release 1 / Serial number 130218 / Inform 7 build 6G60 (I6/v6.32 lib 6/12N) SD

Bedroom
Your bedroom is rather boring.  It contains your bed - currently unmade - and the usual assortment of bedroom furnishings including a bedside table, next to the bed.

On the bedside table are a watch and a phone.

You can go north and west from here.

>purloin memory
[Purloined.]

>purloin broadcast
[Purloined.]

>drop chips
broadcast chip: Dropped.
memory chip: Dropped.

>take chips
memory chip: Taken.
broadcast chip: Taken.

>w
Hall
The central hallway of your modest home.  It's relatively clean and neat, as there is no furniture in it.

You can go north, east to the Bedroom and west from here.

>w
Kitchen
Your kitchen is decorated in a style some four decades old, which is probably when it was last renovated.  It is fairly clean, reflecting the fact that you don't cook for yourself much.

You can see a refrigerator (closed), a thermos (closed) and a microwave oven (closed and empty) here.

You can go north and east to the Hall from here.

>put chips in oven
broadcast chip: The microwave oven is closed.
memory chip: The microwave oven is closed.

>restart
Are you sure you want to restart?

>yes
Welcome to the surveillance society.  Every citizen has been scanned, chipped, folded, spindled and mutilated - and it's enough to make you scream.

Valley of Steel
A tale of the surveillance society by The Custodian of http://everything2.com
Release 1 / Serial number 130217 / Inform 7 build 6G60 (I6/v6.32 lib 6/12N) SD

Bedroom
Your bedroom is rather boring.  It contains your bed - currently unmade - and the usual assortment of bedroom furnishings including a bedside table, next to the bed.

On the bedside table are a watch and a phone.

You can go north and west from here.

>wear watch
(first taking the watch)
You put on the watch.

>w
Hall
The central hallway of your modest home.  It's relatively clean and neat, as there is no furniture in it.

You can go north, east to the Bedroom and west from here.

* * *

>n
Entry
This is the small entryway to your apartment. A pile of mail, most of it unread, covers the small table just inside your front door.  The apartment hallway is to the south.  To the west is your office, and to the east is your bathroom.

You can see a side table (on which is a car key) here.

You can go north through the Front door (closed), south to the Hall, east and west from here.

>n
(first opening the Front door)
You permit the apartment door scanner to scan your eye.

Home Lobby
The slightly shabby front lobby of your building.  A door leads outside to the west, gated stairs leading up to the upper two floors are to the east, and your apartment door is to the south.

You can go south through the Front door to Entry and west through the House door (closed) from here.

The automatic door slides closed.

>take key
You can't see any such thing.

>s
(first opening the Front door)
You permit the apartment door scanner to scan your eye.

Entry
This is the small entryway to your apartment. A pile of mail, most of it unread, covers the small table just inside your front door.  The apartment hallway is to the south.  To the west is your office, and to the east is your bathroom.

You can see a side table (on which is a car key) here.

You can go north through the Front door to Home Lobby, south to the Hall, east and west from here.

The automatic door slides closed.

>take key
Taken.

* * *

>w
Home Office
Your home office, a room which in other homes might be a living room, is not very tidy.  Books, random equipment and empty soda cans cover most available surfaces except for your workbench and your laptop.

You can see a workbench (on which are a multitool, a lockblade knife, a soldering iron, some solder and a laptop) here.

You can go south and east to Entry from here.

>take knife
This knife is large enough to run afoul of local weapons laws.  It would be a bad idea to let it be seen where the police are watching.

>cut key with knife
You carefully cut open the car keys with your knife and peel back the rubber to reveal a broadcast chip and a memory chip.

>put knife in pack
You put the lockblade knife into the backpack.

>s
Kitchen
Your kitchen is decorated in a style some four decades old, which is probably when it was last renovated.  It is fairly clean, reflecting the fact that you don't cook for yourself much.

You can see a refrigerator (closed), a thermos (closed) and a microwave oven (closed and empty) here.

You can go north to the Home Office and east to the Hall from here.

>put chips in oven
There are none at all available!

>actions
Actions listing on.

>put chips in oven
There are none at all available!

>rules
Rules tracing now switched on. Type "rules off" to switch it off again, or "rules all" to include even rules which do not apply.

>put chips in oven
There are none at all available!

>l
[Rule "determine visibility ceiling rule" applies.]
[looking]
[Rule "room description heading rule" applies.]
Kitchen
[Rule "room description body text rule" applies.]
Your kitchen is decorated in a style some four decades old, which is probably when it was last renovated.  It is fairly clean, reflecting the fact that you don't cook for yourself much.

[Rule "room description paragraphs about objects rule" applies.]
[Rule "don't mention player's supporter in room descriptions rule" applies.]
[Rule "don't mention scenery in room descriptions rule" applies.]
[Rule "don't mention undescribed items in room descriptions rule" applies.]
[Rule "set pronouns from items in room descriptions rule" applies.]
[Rule "offer items to writing a paragraph about rule" applies.]
[Rule "use initial appearance in room descriptions rule" applies.]
[Rule "describe what's on scenery supporters in room descriptions rule" applies.]
[Rule "don't mention player's supporter in room descriptions rule" applies.]
[Rule "don't mention scenery in room descriptions rule" applies.]
[Rule "don't mention undescribed items in room descriptions rule" applies.]
[Rule "set pronouns from items in room descriptions rule" applies.]
[Rule "offer items to writing a paragraph about rule" applies.]
[Rule "use initial appearance in room descriptions rule" applies.]
[Rule "describe what's on scenery supporters in room descriptions rule" applies.]
[Rule "don't mention player's supporter in room descriptions rule" applies.]
[Rule "don't mention scenery in room descriptions rule" applies.]
[Rule "don't mention undescribed items in room descriptions rule" applies.]
[Rule "set pronouns from items in room descriptions rule" applies.]
[Rule "offer items to writing a paragraph about rule" applies.]
[Rule "use initial appearance in room descriptions rule" applies.]
[Rule "describe what's on scenery supporters in room descriptions rule" applies.]
[Rule "don't mention player's supporter in room descriptions rule" applies.]
[Rule "don't mention scenery in room descriptions rule" applies.]
[Rule "don't mention undescribed items in room descriptions rule" applies.]
[Rule "set pronouns from items in room descriptions rule" applies.]
[Rule "offer items to writing a paragraph about rule" applies.]
[Rule "use initial appearance in room descriptions rule" applies.]
[Rule "describe what's on scenery supporters in room descriptions rule" applies.]
You can see a refrigerator (closed), a thermos (closed) and a microwave oven (closed and empty) here.

[Rule "check new arrival rule" applies.]
[Rule "exits rule" applies.]
[Rule "darkness hides exits rule" applies.]
[Rule "darkness hides exits rule" applies.]
You can go [Rule "darkness hides exits rule" applies.]
[Rule "darkness hides exits rule" applies.]
north to the Home Office and east to the Hall from here.

[Rule "other people looking rule" applies.]
[looking - succeeded]

>i
[taking inventory]
[Rule "print empty inventory rule" applies.]
[Rule "print standard inventory rule" applies.]
You are carrying:
  a car key (open)
    a broadcast chip
    a memory chip
  a watch (being worn)
  a backpack (being worn and open)
    a lockblade knife

[Rule "report other people taking inventory rule" applies.]
[taking inventory - succeeded]

>put
What do you want to put on?

>put chips
I didn't understand that sentence.

>put chips in oven
There are none at all available!

>take chips
[taking the broadcast chip]
broadcast chip: [Rule "can't take yourself rule" applies.]
[Rule "can't take other people rule" applies.]
[Rule "can't take component parts rule" applies.]
[Rule "can't take people's possessions rule" applies.]
[Rule "can't take items out of play rule" applies.]
[Rule "can't take what you're inside rule" applies.]
[Rule "can't take what's already taken rule" applies.]
[Rule "can't take scenery rule" applies.]
[Rule "can only take things rule" applies.]
[Rule "can't take what's fixed in place rule" applies.]
[Rule "use player's holdall to avoid exceeding carrying capacity rule" applies.]
[Rule "can't exceed carrying capacity rule" applies.]
[Rule "standard taking rule" applies.]
[Rule "standard report taking rule" applies.]
Taken.
[taking the broadcast chip - succeeded]
[taking the memory chip]
memory chip: [Rule "can't take yourself rule" applies.]
[Rule "can't take other people rule" applies.]
[Rule "can't take component parts rule" applies.]
[Rule "can't take people's possessions rule" applies.]
[Rule "can't take items out of play rule" applies.]
[Rule "can't take what you're inside rule" applies.]
[Rule "can't take what's already taken rule" applies.]
[Rule "can't take scenery rule" applies.]
[Rule "can only take things rule" applies.]
[Rule "can't take what's fixed in place rule" applies.]
[Rule "use player's holdall to avoid exceeding carrying capacity rule" applies.]
[Rule "can't exceed carrying capacity rule" applies.]
[Rule "standard taking rule" applies.]
[Rule "standard report taking rule" applies.]
Taken.
[taking the memory chip - succeeded]

* * *

Welcome to the surveillance society.  Every citizen has been scanned, chipped, folded, spindled and mutilated - and it's enough to make you scream.

Valley of Steel
A tale of the surveillance society by The Custodian of http://everything2.com
Release 1 / Serial number 130218 / Inform 7 build 6G60 (I6/v6.32 lib 6/12N) SD

Bedroom
Your bedroom is rather boring.  It contains your bed - currently unmade - and the usual assortment of bedroom furnishings including a bedside table, next to the bed.

On the bedside table are a watch and a phone.

You can go north and west from here.

>gonear ATM
The Bank
This is a completely nondescript bank storefront which exists solely to house an ATM.  It's so nondescript, in fact, you can't even really tell which bank owns it, probably to ensure that they can charge you access fees no matter what.  To the east is Green Commercial Plaza.

You can see an ATM here.

You can go southeast and east from here.

>l atm
This is a standard ATM, using palm prints or Mit-Klein authentication to permit customers to perform banking transactions. A palm reader juts out from the front of the console.

The ATM is currently switched off.

>rules
Rules tracing now switched on. Type "rules off" to switch it off again, or "rules all" to include even rules which do not apply.

>l atm
[Rule "(rule at address 145285)" applies.]
This is a standard ATM, using palm prints or Mit-Klein authentication to permit customers to perform banking transactions. A palm reader juts out from the front of the console.

[Rule "(rule at address 145453)" applies.]
[Rule "(rule at address 145564)" applies.]
[Rule "(rule at address 145816)" applies.]
[Rule "(rule at address 145947)" applies.]
The ATM is currently switched off.

[Rule "(rule at address 146058)" applies.]
[Rule "(rule at address 146742)" applies.]

* * *

>gonear ATM
The Bank
This is a completely nondescript bank storefront which exists solely to house an ATM.  It's so nondescript, in fact, you can't even really tell which bank owns it, probably to ensure that they can charge you access fees no matter what.  To the east is Green Commercial Plaza.

You can see an ATM here.

You can go southeast and east from here.

>actions
Actions listing on.

* * *

>use atm
How would you like to use the ATM?

>switch on atm
[switching on the ATM]
[Rule "Instead of an actor switching on the ATM" applies.]
The palm reader appears to be broken; it does not respond.
You start to reach out to use the ATM, but the machine is unable to contact your MitKlein Encapsulation.  It flashes a red light and shuts off.
[switching on the ATM - ended without result]

>use the atm
How would you like to use the ATM?

* * *

Welcome to the surveillance society.  Every citizen has been scanned, chipped, folded, spindled and mutilated - and it's enough to make you scream.

Valley of Steel
A tale of the surveillance society by The Custodian of http://everything2.com
Release 1 / Serial number 130218 / Inform 7 build 6G60 (I6/v6.32 lib 6/12N) SD

Bedroom
Your bedroom is rather boring.  It contains your bed - currently unmade - and the usual assortment of bedroom furnishings including a bedside table, next to the bed.

On the bedside table are a watch and a phone.

You can go north and west from here.

>purloin tool
[Purloined.]

>gonear green commercial plaza center
Green Commercial Plaza Center
This is the center of the Green Commercial Plaza.  There is a fountain here with a pair of benches facing it.  The plaza continues to the north and south; to the east is a bar called (ironically, you hope) the Proletariat.  To the west is a Bistro Paris cafe.

You can see a trash can (closed) here.

You can go north, northeast, northwest, south, southeast, east and west from here.

* * *

>rules
Rules tracing now switched on. Type "rules off" to switch it off again, or "rules all" to include even rules which do not apply.

>open panel
[opening the solar panel]
[Rule "Check opening a solar panel" applies.]
You pry loose the solar panel with the multitool, ignoring the cracking sounds.

[Rule "can't open unless openable rule" applies.]
[Rule "can't open what's locked rule" applies.]
[Rule "can't open what's already open rule" applies.]
[Rule "standard opening rule" applies.]
[Rule "reveal any newly visible interior rule" applies.]
You open the solar panel, revealing a broadcast chip.
[opening the solar panel - succeeded]

>showme
Green Commercial Plaza Center - room
    Public Surveillance Notice - backdrop
    yourself - person
        your palm (part of yourself) - palm
        your eye (part of yourself) - eye
        MitKlein (part of yourself)
        multitool
        backpack (worn) - player's holdall
    trash can - trash can
        solar panel (part of trash can) - solar panel
            broadcast chip - broadcast chip
        *rubbish - rubbish
* denotes things which are not in scope

>show me
What do you want to show yourself?

>showme me
yourself - person
    your palm (part of yourself) - palm
    your eye (part of yourself) - eye
    MitKlein (part of yourself)
    multitool
    backpack (worn) - player's holdall
location: in Green Commercial Plaza Center
singular-named, proper-named; unlit, inedible, portable, assembled; male
printed name: "yourself"
printed plural name: "people"
indefinite article: none
description: "As good-looking as ever."
initial appearance: none
size: medium
carrying capacity: 5
suspicionState: clear

>z
[waiting]
[Rule "standard report waiting rule" applies.]
Time passes.
[waiting - succeeded]

You're pretty sure the police saw you do that.  They'll be looking for you now.

[Rule "scene description text rule" applies.]