A rare moment of rest.  Your mission to steal specifications of the MitKlein Encapsulation - the ID transponder embedded in every citizen's head, even yours - was successful, and you transmitted your report to Central early this morning.   You expect a new assignment soon, even if it is only instructions to fall back into a cover identity, as you have been on the front lines of the underground struggle against Homeland Security nearly from the start.  Giving up your birth identity and life, moving instead into the flickery half-existence of an underground operative, you've sabotaged, stolen, publicized, verified and fought for years now.  Hopefully, this last mission means that a strategy to counter the government's ubiquitous tagging of citizens is being worked out at levels above your own head.

For now, you have found yourself a small quiet park in a quiet corner of the City.

Welcome to the future.  Every citizen has been scanned, chipped, folded, spindled and mutilated - and it's enough to make you scream.

Valley of Steel
A tale of the surveillance society by The Custodian of http://everything2.com
Release 3 / Serial number 140325 / Inform 7 build 6G60 (I6/v6.32 lib 6/12N) SD

Green Residential Park
Primrose Street ends here in a small circular cul-de-sac.  You're in a small green park to the north of this, bounded on its three other sides by high fences.  A few trees rise over well-manicured grass.  There is a curfew sign at the park's entrance.

The Reserve Bank Spacescraper is visible in the distance, rising over the low skyline.

You can go south from here.

There is a Public Surveillance Notice here.

>gonear roughit
RoughIt
This diorama of a shop is the City's largest camping and outdoors supplier.  Although the store is full of equipment, it's just props, firmly secured - because everything is only available via an automated vending system, provided you don't mind your purchases being relentlessly catalogued by the Department of Homeland Security.  You stopped shopping here after they told you you couldn't buy a coffee without using biometric authentication.  One item catches your eye, though - there is a metal thermos sitting out of place atop the vending system.  Someone must have forgotten it.

On the vending system is a thermos (closed).

You can go southwest and west from here.

>gonear maintenance closet
There seems to be no such object anywhere in the model world.

>gonear solvents cabinet
Utility Closet
The maintenance closet is dimly lit and, ironically, not terribly clean.  There are various cleaning implements and supplies stored on shelves around the walls, a fire equipment wall rack, and a large metal solvents cabinet taking up one wall.  A flourescent light panel flickers wanly in the ceiling. Two doors lead out of the closet, one east and one west.

On the wall rack are a gas mask and a Fire Axe.

A scuffed disposable camera with a building property sticker on it is here.  Written on it in marker are the words "DOCUMENT ALL MAINTENANCE ITEMS."

You can go east through the Maintenance Door (closed) and west from here.

>melt mask
That's not a verb I recognize.

>score
The score is this: you're being hunted, and there's not much good that will come out of small measures and half-successes.  In the end, they will win or you'll be free.

>w
Maintenance Corridor
This is the middle of a short corridor running north to south.  The walls are gray-painted cinderblocks and have many scuff marks and scars.  The floor is an industrial non-slip surfaced concrete.  A door to the east is marked "STORAGE."

You can go north, south, and east to the Utility Closet from here.

* * *

>s
South End of Maintenance Corridor
The corridor extends to the north from here.  To the west is a service bouncelift.

You can go north to Maintenance Corridor and west from here.

>n
Maintenance Corridor
This is the middle of a short corridor running north to south.  The walls are gray-painted cinderblocks and have many scuff marks and scars.  The floor is an industrial non-slip surfaced concrete.  A door to the east is marked "STORAGE."

You can go north, south to South End of Maintenance Corridor, and east to the Utility Closet from here.

>n
North End of Maintenance Corridor
The corridor comes to an end here.  To the north is large door marked "HVAC ACCESS" which is closed and securely locked.  A bulletin board on the wall to the right contains a dizzying array of official Workplace Notices, all of which bear the symbol of the Health and Safety Board.

You can go south to Maintenance Corridor from here.

There is a quiet tone from your phone and you feel a short vibration, indicating that an SMS message has arrived.

>l board
You examine that but find nothing of interest.

>l bulleting board
You can't see any such thing.

>l bulletin
That won't help you.

>s
Maintenance Corridor
This is the middle of a short corridor running north to south.  The walls are gray-painted cinderblocks and have many scuff marks and scars.  The floor is an industrial non-slip surfaced concrete.  A door to the east is marked "STORAGE."

You can go north to North End of Maintenance Corridor, south to South End of Maintenance Corridor, and east to the Utility Closet from here.

>s
South End of Maintenance Corridor
The corridor extends to the north from here.  To the west is a service bouncelift.

You can go north to Maintenance Corridor and west from here.

* * *

>e
You angle yourself towards the door.  The liftfield gently moves you to the edge of the tube, and you swing yourself out of the lift via the safety handle.

Bouncelift Vestibule
The service bouncelift opens onto a small vestibule, not much larger than the size of a closet.  A sign painted on the wall reads "LEVEL 35 - MEZZANINE". There is a door with a palm lock to the east.

You can go east through Vestibule Door (closed) and west to Top of Service Bouncelift from here.

>e
(first opening Vestibule Door)
It seems to be locked.

A quiet tone from your phone indicates that you have unread SMS messages.

>l lock
A retrofitted palm lock which juts out from the door's surface.

>take lock
That seems to be a part of Vestibule Door.

>open lock
That's not something you can open.

* * *

>gonear transit capsule
Transit Capsule
A fifty-person maglev Transit capsule.  You're standing, holding on to a strap.  A deep hum resonates through your bones, indicating that the Vectorfield is active.  Outside the narrow windows, the tunnel is dark.  Occasional blurry streaks show lights flashing past the moving Capsule. Several riders share the Capsule with you.

>station reserve bank
You can't see any such thing.

>station
What do you want to station?

>action
You can't see any such thing.

>actions
Actions listing on.

>station
What do you want to station?

>station watch
[waiting for station the watch]
That's not a station.
[waiting for station the watch - failed the Check waiting for station]

>station Reserve Bank Platform
You can't see any such thing.

* * *

>gonear transit capsule
Transit Capsule
A fifty-person maglev Transit capsule.  You're standing, holding on to a strap.  A deep hum resonates through your bones, indicating that the Vectorfield is active.  Outside the narrow windows, the tunnel is dark.  Occasional blurry streaks show lights flashing past the moving Capsule. Several riders share the Capsule with you.

>station Reserve Bank Platform
I didn't understand that sentence.

>station Green Residential One
I didn't understand that sentence.

>rules
Rules tracing now switched on. Type "rules off" to switch it off again, or "rules all" to include even rules which do not apply.

* * *

>actions
Actions listing on.

>station Green Residential One
I didn't understand that sentence.

>station
I didn't understand that sentence.

>station Bedroom
I didn't understand that sentence.

>frotz Green Residential one
You can't see any such thing.

* * *

>frotz Reserve Bank Station
I didn't understand that sentence.

>frotz
I didn't understand that sentence.

* * *

>gonear green residential platform
Green Residential Platform
Green Residential's platform serves mostly residential commuters.  There is an exit at the center of the platform which leads east through a set of closed automatic doors to a stairway leading up to the main station, just next to a large plaque with the name of the station on it.  The platform abuts the Transit web to the west, now empty.

You can see a Transit Map here.

You can go east through the Green Residential Station door (closed) from here.

>wait for capsule
There is a quiet tone from your phone and you feel a short vibration, indicating that an SMS message has arrived.

A tiny surveillance camera you're sure you didn't see before swivels to follow you.

A quiet tone from your phone indicates that you have unread SMS messages.

A light grows in the tunnel.  With a deep thrumming and the whoosh of displaced air, the Transit Capsule slides smoothly into Green Residential Platform and comes to a stop, hovering in the Web.  The doors slide open and a few commuters enter and exit the capsule.
A few commuters get on and off the Transit capsule.

>n
You can't go that way.

>enter
You must supply a noun.

A few commuters get on and off the Transit capsule.

A quiet tone from your phone indicates that you have unread SMS messages.

>wait for Green Commercial One
I only understood you as far as wanting to wait.

>actions
Actions listing on.

>wait for Green Commercial One
I only understood you as far as wanting to wait.

>rules
Rules tracing now switched on. Type "rules off" to switch it off again, or "rules all" to include even rules which do not apply.

>wait for Reserve Bank station
I only understood you as far as wanting to wait.

>wait Reserve Bank
I only understood you as far as wanting to wait.

* * *

>gonear bouncelift vestibule
Bouncelift Vestibule
The service bouncelift opens onto a small vestibule, not much larger than the size of a closet.  A sign painted on the wall reads "LEVEL 35 - MEZZANINE". There is a door with a palm lock to the east.

You can go east through Vestibule Door (closed) and west from here.

>purloin palm sample
There seems to be no such object anywhere in the model world.

>purloin palm
Which do you mean, your palm, the Bartender's palm, a man's palm, the shopkeeper's palm, the shopper's palm, Officer Prescott's palm, the Patrolman's palm, Sergeant Ramirez's palm, the Security Guard's palm, a palm, Ponyfriend Chunky's palm, the palm reader, the drinkers's palm, the civil servants's palm, or the cops's palm?

>purloin skin sample
[Purloined.]

>wear skin sample
Fortunately it's sticky enough to adhere to your palm.

You put on the skin sample.

>touch lock
You feel nothing unexpected.

>palm lock
You can't unlock Vestibule Door lock.

* * *

>gonear cryopack
Hospital Lab
This is an all-purpose pathology laboratory receiving area.  The lab itself is behind a bulletproof glass wall to the east, and a small window allows samples or paperwork to be passed back and forth.

You can see a cryopack (closed) and a trash can (closed) here.

You can go west from here.

>take cryopack
Taken.

>purloing skin sample
That's not a verb I recognize.

>purloin skin sample
[Purloined.]

>open crypcak
You can't see any such thing.

>open cryopack
You open the cryopack. A small cloud of chill and condensation escapes from the cryopack into the surrounding air.  The green LED on it goes out; a red one lights up.

>put sample in cryopack
You put the skin sample into the cryopack.

>close cryopack
You close the cryopack.

>open cryopack
You open the cryopack, revealing a skin sample.

There is a quiet tone from your phone and you feel a short vibration, indicating that an SMS message has arrived.

>take sample
Taken.

>w
Hospital Lounge
This lounge is full of marginally-comfortable seating and antiquated magazines.  A door to the east reads "LAB" and the main lobby is to the south.  It is deserted; looking at the decor, you're pretty sure you know why.

You can go south and east to the Hospital Lab from here.

>s
Hospital Lobby
This is the main entrance to a busy regional hospital. Autodoors lie to the west.  Patients and staff rush back and forth, all too busy to pay you any attention.  To the south is an archway with a sign reading "TRIAGE"; to the east is the elevator core and to the north is the waiting lounge.

You can go north to Hospital Lounge, south, east, and west through the Hospital door (closed) from here.

There is a Public Surveillance Notice here.

>s
Triage
This is a triage area for the ER to the east.  To the north is the main Hospital lobby, and west lies the automatic doors out to the driveway.  Patients and staff are moving back and forth through the area.

You can go north to Hospital Lobby, east, and west through the ER door (closed) from here.

There is a Public Surveillance Notice here.

>e
Emergency Room
This is a prep and emergency treatment area for the emergency ward to the east, which is locked.  Triage is to the west, and a door leads north.  The ER is presently unused, and lies empty.

You can see a tissue generator here.

You can go north and west to Triage from here.

There is a Public Surveillance Notice here.

>put cryopack in sample slot
You put the cryopack into the sample slot.

>purloin tissue sampler
[Purloined.]

>palm sampler
You press your palm to the tissue sample plate; it glows briefly.

A quiet tone from your phone indicates that you have unread SMS messages.

>put sampler in read slot
You put the tissue sampler (yourself) into the read slot.

>switch generator
(the tissue generator)
Lights flash and the machine hums for a while. With a final hiss, the tissue generator lights an indicator reading "COMPLETE."  You notice the cryopack is now closed and operating.

>take cryopack
Taken.

>open cryopack
You open the cryopack. A small cloud of chill and condensation escapes from the cryopack into the surrounding air.  The green LED on it goes out; a red one lights up. There is a skin sample inside the cryopack.

* * *

>s
Primrose & Station
This staid neighborhood intersection of Primrose Lane and Cedar Street fronts the local Transit station, Green Residential.  The station entrance is to the west.  Primrose Lane continues to the south.

The Reserve Bank Spacescraper is visible in the distance, rising over the low skyline.

You can go north to Green Residential Park, south, and west from here.

There is a Public Surveillance Notice here.

* * *

>gonear roberto velez
The Proletariat Bar
The Proletariat is a local bar (not a pub).  It's just far enough above a "dive" to be allowed zoning here, but steadfastedly refuses to cater to upscale tastes.  You like it.  Restrooms are to the east; the bar runs along the north side with a stolid bartender behind it and a jukebox sits against the back wall.  A few hardy drinkers sit here, communing with their spirits.  In a nod to the place's name, a Public Surveillance Notice covered with stickers and graffiti tags has been framed above the bar.

You can see a Bartender and a man here.

You can go northwest, southwest, east, and west from here.

>x man
A medium-height man of middle age and dark but somewhat pasty-looking skin.  His hair, black and cut short, is just beginning to grey at the temples.  His hands are rough and callused.  He is wearing work shoes and dark blue trousers, slightly scuffed.  He is wearing a dark blue trade uniform jacket with a long narrow gash at the left shoulder and his name (Roberto Velez) on a tag clipped to the breast.

>purloin tissue sample
There seems to be no such object anywhere in the model world.

>purloin tissue sampler
[Purloined.]

>purloin blue jacket
[Purloined.]

>offer blue jacket to roberto
(Roberto Velez)
Roberto stands up and eagerly examines the blue jacket.  "This would be a perfect replacement!" he says enthusiastically, showing you how closely it resembles his torn uniform jacket.  "Would you be willing to part with it? I cannot give you much, but I would happily pay you what I can; it will be less than what those dogs would take from my salary to replace this one!" He pats his pockets, then shakes his head.  "I need to go to the ATM."  With that, he stands up.

Roberto Velez goes northwest.

>nw
Green Commercial Plaza North
Green Commercial One is built around a plaza, and this is its northern end.  No vehicles are permitted within the public areas of Green Commercial One, so the entire area is pedestrian-only.  To the north are the doorways to the Green Commercial Station.  To the east is RoughIt.  To the west is a storefront bank with an ATM.  The plaza continues to the south.

The Reserve Bank Spacescraper is visible in the distance, rising over the low skyline.

You can also see Roberto Velez and a trash can (closed) here.

You can go north, south, southeast to The Proletariat Bar, southwest, east, and west from here.

There is a Public Surveillance Notice here.

Roberto Velez goes west.

>w
Metro Savings
This is a completely nondescript bank storefront which exists solely to house an ATM.  It's so nondescript, in fact, that it took you some actual effort to determine which bank owns it, probably to ensure that they can charge you access fees no matter what.  To the east is Green Commercial Plaza.

You can see Roberto Velez and an ATM here.

You can go southeast and east to Green Commercial Plaza North from here.

There is a Public Surveillance Notice here.

Roberto approaches the ATM, intent on withdrawing funds to pay you for the blue jacket.
He looks at the ATM's cracked palm reader, then at you.  "The ATM scanner, he is broken."  He shakes his head.

>put sampler in palm reader
You carefully fit the tissue sampler into the hollow of the palm reader so that it lies over the read area.

Roberto approaches the ATM, intent on withdrawing funds to pay you for the blue jacket.
Roberto places his palm on the sampler, hidden inside the ATM.  It flashes briefly.  Nothing else happens.
He shakes his head.  "I am sorry, but the machine is broken."  You reassure him that you don't need paying for the jacket, at which he breaks out into a huge smile, gives you a hug, shakes your hand and quickly changes into the new blue jacket, dropping his torn jacket.  He walks out of the ATM, proudly fingering his new wardrobe.

There is a quiet tone from your phone and you feel a short vibration, indicating that an SMS message has arrived.

>take sampler
Taken.

>gonear tissue generator
Which do you mean, the tissue generator's activate button or the tissue generator?

>gonear cryopack
Hospital Lab
This is an all-purpose pathology laboratory receiving area.  The lab itself is behind a bulletproof glass wall to the east, and a small window allows samples or paperwork to be passed back and forth.

You can see a cryopack (closed) and a trash can (closed) here.

You can go west from here.

* * *

>take cryopack
Taken.

>s
You can't go that way.

>w
Hospital Lounge
This lounge is full of marginally-comfortable seating and antiquated magazines.  A door to the east reads "LAB" and the main lobby is to the south.  It is deserted; looking at the decor, you're pretty sure you know why.

You can go south and east to the Hospital Lab from here.

* * *

>s
Hospital Lobby
This is the main entrance to a busy regional hospital. Autodoors lie to the west.  Patients and staff rush back and forth, all too busy to pay you any attention.  To the south is an archway with a sign reading "TRIAGE"; to the east is the elevator core and to the north is the waiting lounge.

You can go north to Hospital Lounge, south, east, and west through the Hospital door (closed) from here.

There is a Public Surveillance Notice here.

>e
Hospital Elevators
The main elevator bank for the hospital seems to require either an appropriate Mit-Klein scan or a hospital ID to swipe.  Patients and staff move through the area. The lobby is to the west.  The ER is through a door to the south, and a restroom is to the east.

You can go south, east, and west to Hospital Lobby from here.

There is a Public Surveillance Notice here.

>s
Emergency Room
This is a prep and emergency treatment area for the emergency ward to the east, which is locked.  Triage is to the west, and a door leads north.  The ER is presently unused, and lies empty.

You can see a tissue generator here.

You can go north to Hospital Elevators and west from here.

There is a Public Surveillance Notice here.

>put cryopack in sample slot
The cryopack must be open before being inserted.

>open cryopack
You open the cryopack. A small cloud of chill and condensation escapes from the cryopack into the surrounding air.  The green LED on it goes out; a red one lights up.

A quiet tone from your phone indicates that you have unread SMS messages.

>put cryopack in sample slot
You put the cryopack into the sample slot.

>l generator
(the tissue generator)
This is a medium-sized appliance found in most modern hospitals.  It is used to provide artificial tissue for grafting into or onto injuries.  In order to prevent rejection, the tissue generator must be given a complete scan of the patient's tissue, from which it will (by default) produce an exact duplicate of the scanned sample.  It has a button marked ACTIVATE. There is a slot on the front of the machine labeled INSERT CRYOPACK FOR SAMPLE where, presumably, the generated tissue is delivered; there is a smaller opening labeled FEED and there is a slot labeled READ where a tissue sampler can be inserted.    There is a cryopack in the sample slot.  The feed slot contains biogen feedstock.

The tissue generator is currently switched off.

>put tissie sampler in read slot
You can't see any such thing.

>put sampler in read slot
You put the tissue sampler (Roberto) into the read slot.

>switch generator
(the tissue generator)
Lights flash and the machine hums for a while. With a final hiss, the tissue generator lights an indicator reading "COMPLETE."  You notice the cryopack is now closed and operating.

* * *

>take cryopack
Taken.

>open cryopack
You open the cryopack. A small cloud of chill and condensation escapes from the cryopack into the surrounding air.  The green LED on it goes out; a red one lights up.

>take sample
(the skin sample)
Taken.

>wear sample
(the skin sample)
Fortunately it's sticky enough to adhere to your palm.

You put on the skin sample.

>gonear maintenance area
Maintenance Area
This corner of the food court is drab and uninhabited.  A closed door marked "MAINTENANCE" lurks to the west, and another marked "RESTROOM" to the north.  The floor and walls are scuffed around the door, no doubt from cleaning implements banging against them on their daily travels.

You can go north, southeast, and west through the Maintenance Door (closed) from here.

>palm lock
(first opening the Maintenance Door)
You press your doctored palm against the scanner.  The lock clicks open.

Utility Closet
The maintenance closet is dimly lit and, ironically, not terribly clean.  There are various cleaning implements and supplies stored on shelves around the walls, a fire equipment wall rack, and a large metal solvents cabinet taking up one wall.  A fluorescent light panel flickers wanly in the ceiling. Two doors lead out of the closet, one east and one west.

On the wall rack are a gas mask and a fire axe.

A scuffed disposable camera with a building property sticker on it is here.  Written on it in marker are the words "DOCUMENT ALL MAINTENANCE ITEMS."

You can go east through the Maintenance Door to Maintenance Area and west from here.

A quiet tone from your phone indicates that you have unread SMS messages.

The automatic door slides closed.

>e
(first opening the Maintenance Door)

Maintenance Area
This corner of the food court is drab and uninhabited.  A closed door marked "MAINTENANCE" lurks to the west, and another marked "RESTROOM" to the north.  The floor and walls are scuffed around the door, no doubt from cleaning implements banging against them on their daily travels.

You can go north, southeast, and west through the Maintenance Door to the Utility Closet from here.

The automatic door slides closed.

>remove sample
You take off the skin sample.

>w
(first opening the Maintenance Door)
The palm lock ignores you. The door remains firmly closed.

>palm lock
(first opening the Maintenance Door)
The palm lock ignores you. The door remains firmly closed.

* * *

>gonear I Have No Mouth
[** Programming error: tried to "move" yourself to nothing **]
Green Residential Park
The Reserve Bank Spacescraper is visible in the distance, rising over the low skyline.

*** Run-time problem P47 (at paragraph 44 in the source text): Phrase applied to an incompatible kind of value.

You can see no obvious exits.

>gonear lift lobby
Lift Lobby
The Lift Lobby controls underground access to the Reserve Bank spacescraper, beneath the towers of industry and capital made pillars of money and sin.  Hundreds of people rush to and fro through the lobby on their way into or out of the building.  To the north is a large bank of bouncelifts, their liftfields on and glowing faintly blue behind security gates.  Access to the bouncelifts is controlled by Lift Scanners, set above and to the right of each bouncelift entry.  There is no ceiling; several meters up, the room opens out into the street level lobby above.  There is a railing around the perimeter of the floor above; several people are leaning against or over it, watching the flow of commuters below them and around you.  The Atrium, a wide open area extending at least halfway up the spacescraper, is visible above that. There is no way to reach the street lobby from here other than via the bouncelifts. A shallow ramp leads east down to the Food Court.

You can hear the confused murmur of a large crowd coming from the Atrium above.

You can see a Powered Platform (on which is a spool) and the Security Guard here.

You can go east and up from here.

>e
Food Court
The center of the Food Court beneath the Reserve Bank spacescraper is a busy place at all times of the day.  Around the periphery are several food stand franchises, some doing a brisk business.  Dozens of customers are here waiting in line at the food stands, sitting at the dozens of tables in the center, or just passing through from the Reserve Bank Station to the Lift Lobby up a ramp to the west or vice versa.  The floor is made of duramex tiles.

You can see a trash can (closed) here.

You can go northwest, east, and west to Lift Lobby from here.

There is a Public Surveillance Notice here.

>rules
Rules tracing now switched on. Type "rules off" to switch it off again, or "rules all" to include even rules which do not apply.

* * *

>actions
Actions listing on.

>l up
(The Sheep Look Up)
[examining The Sheep Look Up]
[Rule "standard examining rule" applies.]
The Sheep Look Up is a gyros restaurant, featuring small cartoon sheep heads looking imploringly up from the steam table behind the glass.  Two surly employees are hard at work slicing gyros and constructing sandwiches and lunch platters for the several hungry customers who wait in line.

[Rule "examine directions rule" applies.]
[Rule "examine containers rule" applies.]
[Rule "examine supporters rule" applies.]
[Rule "examine devices rule" applies.]
[Rule "examine undescribed things rule" applies.]
[Rule "report other people examining rule" applies.]
[examining The Sheep Look Up - succeeded]

* * *

>gonear lift lobby
Lift Lobby
The Lift Lobby controls underground access to the Reserve Bank spacescraper, beneath the towers of industry and capital made pillars of money and sin.  Hundreds of people rush to and fro through the lobby on their way into or out of the building.  To the north is a large bank of bouncelifts, their liftfields on and glowing faintly blue behind security gates.  Access to the bouncelifts is controlled by Lift Scanners, set above and to the right of each bouncelift entry.  There is no ceiling; several meters up, the room opens out into the street level lobby above.  There is a railing around the perimeter of the floor above; several people are leaning against or over it, watching the flow of commuters below them and around you.  The Atrium, a wide open area extending at least halfway up the spacescraper, is visible above that. There is no way to reach the street lobby from here other than via the bouncelifts. A shallow ramp leads east down to the Food Court.

You can hear the confused murmur of a large crowd coming from the Atrium above.

You can see a Powered Platform (on which is a spool) and the Security Guard here.

You can go east and up from here.

* * *

>buy ice cream
You can't see any such thing.

>actions
Actions listing on.

>buy
What do you want to buy?

>buy trash can
[buying the trash can]
You have no funds, and even if the trash can was available for sale, you don't dare allow your MItKlein to be scanned.
[buying the trash can - failed]

>l commuter
You can't see any such thing.

>l customer
[examining the customer]
Customers seeking a quick meal.

[examining the customer - succeeded]

>l rider
You can't see any such thing.

>l customer
[examining the customer]
Customers seeking a quick meal.

[examining the customer - succeeded]

* * *

>l customers
You see a distracted tech worker with some flowers.

>l customers
You see a elderly executive juggling some packages.

>l customer
You see a smiling delivery worker towing a travel case.

>gonear transit capsule
Transit Capsule
A fifty-person maglev Transit capsule.  You're standing, holding on to a strap.  A deep hum resonates through your bones, indicating that the Vectorfield is active.  Outside the narrow windows, the tunnel is dark.  Occasional blurry streaks show lights flashing past the moving Capsule. Several riders share the Capsule with you.

>l transit riders
You can't see any such thing.

>l riders
You see a distracted tech worker juggling some packages.

>l man
You see a middle-aged student carrying a newspaper.

>l woman
You see a worried tech worker carrying a newspaper.

>l I Have No Mouth
You can't see any such thing.

>gonear Food Court
Which do you mean, Food Court, The Food Court Restroom, the Food Court Restroom mirror, the Food Court Restroom mirror's reflection, or the Food Court Restroom mirror's doodle?

>gonear lift lobby
Lift Lobby
The Lift Lobby controls underground access to the Reserve Bank spacescraper, beneath the towers of industry and capital made pillars of money and sin.  Hundreds of people rush to and fro through the lobby on their way into or out of the building.  To the north is a large bank of bouncelifts, their liftfields on and glowing faintly blue behind security gates.  Access to the bouncelifts is controlled by Lift Scanners, set above and to the right of each bouncelift entry.  There is no ceiling; several meters up, the room opens out into the street level lobby above.  There is a railing around the perimeter of the floor above; several people are leaning against or over it, watching the flow of commuters below them and around you.  The Atrium, a wide open area extending at least halfway up the spacescraper, is visible above that. There is no way to reach the street lobby from here other than via the bouncelifts. A shallow ramp leads east down to the Food Court.

You can hear the confused murmur of a large crowd coming from the Atrium above.

You can see a Powered Platform (on which is a spool) and the Security Guard here.

You can go east to Food Court and up from here.

>e
Food Court
The center of the Food Court beneath the Reserve Bank spacescraper is a busy place at all times of the day.  Around the periphery are several food stand franchises, some doing a brisk business.  Dozens of customers are here waiting in line at the food stands, sitting at the dozens of tables in the center, or just passing through from the Reserve Bank Station to the Lift Lobby up a ramp to the west or vice versa.  The floor is made of duramex tiles.

You can see a trash can (closed) here.

You can go northwest, east, and west to Lift Lobby from here.

There is a Public Surveillance Notice here.

>l I have No mouth
I Have No Mouth (but Ice Cream) is a popular frozen dessert chain.  Despite the somewhat disturbing corporate artwork and iconography, this counter offers a selection of solid flavors including Chocolate AMmond, PostApocalicks and We've All Gone Tutti-Frutti.  Two scoopers behind the counter are smoothly dishing up cones and cups to a large crowd of midday sweet-seekers.

>l tacos terriff
Tacos Terriff is a bare-bones Mexicalitexazonan food joint.  Meat product is scooped into grain-plastic shells and covered with various unidentifiable industrial sauces and shredded veggies.  Despite this, it seems to have a dedicated following, as it is doing land-office business with the office set.

>l apollos
Apollo's Coffee is done up in fake Ancient Greek, as befits its name. Plastic busts and columns adorn its facade.  For some reason, there is a silver robotic head behind the counter, mounted on the wall, where a red scanning laser moves monotonously back and forth.

>l apollo's
Apollo's Coffee is done up in fake Ancient Greek, as befits its name. Plastic busts and columns adorn its facade.  For some reason, there is a silver robotic head behind the counter, mounted on the wall, where a red scanning laser moves monotonously back and forth.

>l up
The ceiling is two levels up, peppered with DayBrite(™) lighting fixtures which make it difficult to see any detail through the glare.

>l down
The floor is made of duramex tiles, nondescript gray matte shedding scuff marks with the determination of the designed servant into nanogrout channels in between.  During the short nighttime lull, the floor will seem to creep slightly as the nanogrout slowly flows the daytime grime along the channels to dispose of it into the walls.

There is a quiet tone from your phone and you feel a short vibration, indicating that an SMS message has arrived.

>l sheep
The Sheep Look Up is a gyros restaurant, featuring small cartoon sheep heads looking imploringly up from the steam table behind the glass.  Two surly employees are hard at work slicing gyros and constructing sandwiches and lunch platters for the several hungry customers who wait in line.

>l the sheep
The Sheep Look Up is a gyros restaurant, featuring small cartoon sheep heads looking imploringly up from the steam table behind the glass.  Two surly employees are hard at work slicing gyros and constructing sandwiches and lunch platters for the several hungry customers who wait in line.

>l the sheep look up
I only understood you as far as wanting to look The Sheep.

>l cones
That won't help you.

>x cones
That won't help you.

>take cones
You can't do that.

>l croissants
That won't help you.

>l robot
Large and chromed silver, this robot's head looks like a large helmet with rudimentary features.  Instead of eyes, a red band crosses the face, behind which a bright red light slowly moves back and forth.

>actions
Actions listing on.

* * *

>rules
Rules tracing now switched on. Type "rules off" to switch it off again, or "rules all" to include even rules which do not apply.

>l up
[examining up]
[Rule "Instead of examining up in the Food Court" applies.]
The ceiling is two levels up, peppered with DayBrite(™) lighting fixtures which make it difficult to see any detail through the glare.
[examining up - failed]

[Rule "Every Turn during Transit Stop" applies.]
[Rule "scene description text rule" applies.]

* * *

>l up
(up)
The ceiling is two levels up, peppered with DayBrite(™) lighting fixtures which make it difficult to see any detail through the glare.

>l the sheep
The Sheep Look Up is a gyros restaurant, featuring small cartoon sheep heads looking imploringly up from the steam table behind the glass.  Two surly employees are hard at work slicing gyros and constructing sandwiches and lunch platters for the several hungry customers who wait in line.

>l down
The floor is made of duramex tiles, nondescript gray matte shedding scuff marks with the determination of the designed servant into nanogrout channels in between.  During the short nighttime lull, the floor will seem to creep slightly as the nanogrout slowly flows the daytime grime along the channels to dispose of it into the walls.

* * *

>purloin sampler
[Purloined.]

>palm sampler
You press your palm to the tissue sample plate; it glows briefly.

* * *

>frotz
You can't see any such thing.

>frotz capsule
You can't see any such thing.

>gonear transit capsule
Transit Capsule
A fifty-person maglev Transit capsule.  You're standing, holding on to a strap.  A deep hum resonates through your bones, indicating that the Vectorfield is active.  Outside the narrow windows, the tunnel is dark.  Occasional blurry streaks show lights flashing past the moving Capsule. Several riders share the Capsule with you.

* * *

>gonear maintenance area
Maintenance Area
This corner of the food court is drab and uninhabited.  A closed door marked "MAINTENANCE" lurks to the west, and another marked "RESTROOM" to the north.  The floor and walls are scuffed around the door, no doubt from cleaning implements banging against them on their daily travels.

You can go north, southeast, and west through the Maintenance Door (closed) from here.

>purloin skins ample
There seems to be no such object anywhere in the model world.

>purloin skin sampl
I only understood you as far as wanting to purloin the skin sample.

>purloin skin sample
[Purloined.]

>w
(first opening the Maintenance Door)
The palm lock ignores you. The door remains firmly closed.

* * *

>palm lock
(first opening the Maintenance Door)
The palm lock ignores you. The door remains firmly closed.

>x lock
The maintenance closet is sealed by an autodoor.  There is no eye scanner on this door, but a flat plate above the door handle indicates a palm scanner lock.

>wear skin sampl
I only understood you as far as wanting to wear the skin sample.

>wear skin sample
Fortunately it's sticky enough to adhere to your palm.

You put on the skin sample.

>palm lock
(first opening the Maintenance Door)
The palm lock ignores you. The door remains firmly closed.

There is a quiet tone from your phone and you feel a short vibration, indicating that an SMS message has arrived.

>actions
Actions listing on.

>palm lock
[palming the Maintenance Door]
[(1) going west]
(first opening the Maintenance Door)
[(2) opening the Maintenance Door - silently]
The palm lock ignores you. The door remains firmly closed.
[(2) opening the Maintenance Door - silently - ended without result]
[(1) going west - failed the can't go through closed doors rule]

[palming the Maintenance Door - succeeded]

>w
[going west]
(first opening the Maintenance Door)
[(1) opening the Maintenance Door - silently]
The palm lock ignores you. The door remains firmly closed.
[(1) opening the Maintenance Door - silently - ended without result]
[going west - failed the can't go through closed doors rule]

>x me
[examining yourself]
You're wearing basic clothing which is almost obsessively nondescript.  You're average in nearly every physical respect - something which didn't win you many accolades growing up, but serves you well in your efforts to blend in with the conformist population through which you now move.

You're wearing a skin sample and a backpack.
You're carrying a multitool, a watch, and a phone.

[examining yourself - succeeded]

* * *

>gonear maintenance area
Maintenance Area
This corner of the food court is drab and uninhabited.  A closed door marked "MAINTENANCE" lurks to the west, and another marked "RESTROOM" to the north.  The floor and walls are scuffed around the door, no doubt from cleaning implements banging against them on their daily travels.

You can go north, southeast, and west through the Maintenance Door (closed) from here.

>l maintenance door
The maintenance closet is sealed by an autodoor.  There is no eye scanner on this door, but a flat plate above the door handle indicates a palm scanner lock.

>l lock
The maintenance closet is sealed by an autodoor.  There is no eye scanner on this door, but a flat plate above the door handle indicates a palm scanner lock.

>touch lock
You feel nothing unexpected.

>palm lock
Nothing happens.