A rare moment of rest.  Your mission to steal specifications of the MitKlein Encapsulation - the ID transponder embedded in every citizen's head, even yours - was successful, and you transmitted your report to Central early this morning.   You expect a new assignment soon, even if it is only instructions to fall back into a cover identity, as you have been on the front lines of the underground struggle against Homeland Security nearly from the start.  Giving up your birth identity and life, moving instead into the flickery half-existence of an underground operative, you've sabotaged, stolen, publicized, verified and fought for years now.  Hopefully, this last mission means that a strategy to counter the government's ubiquitous tagging of citizens is being worked out at levels above your own head.

For now, you have found yourself a small quiet park in a quiet corner of the City.

Welcome to the future.  Every citizen has been scanned, chipped, folded, spindled and mutilated - and it's enough to make you scream.

Valley of Steel
A tale of the surveillance society by The Custodian of http://everything2.com
Release 1 / Serial number 130427 / Inform 7 build 6G60 (I6/v6.32 lib 6/12N) SD

Green Residential Park
Primrose Street ends here in a small circular cul-de-sac.  You're in a small green park to the north of this, bounded on its three other sides by high fences.  A few trees rise over well-manicured grass.  There is a curfew sign at the park's entrance.

The Reserve Bank Spacescraper is visible in the distance, rising over the low skyline.

You can go south from here.

There is a Public Surveillance Notice here.

>l spacescraper
Visible in the distance above the surrounding buildings, the Reserve Bank Spacescraper is home to more than just the regional Reserve Bank.  It is a two-hundred-level building containing all manner of businesses and government offices, as well as a hotel and several floors of extremely high-priced residential apartments.  Centrally located Downtown, it boasts its own Transit station and a food court in its lower levels.  Conventions and events are often held in its soaring Atrium, an open space within the building core which rises over fifty floors entirely indoors.  It is several miles away.

>touch spacescraper
That would be a very neat trick.  It's miles away in any case.

>look
Green Residential Park
Primrose Street ends here in a small circular cul-de-sac.  You're in a small green park to the north of this, bounded on its three other sides by high fences.  A few trees rise over well-manicured grass.  There is a curfew sign at the park's entrance.

The Reserve Bank Spacescraper is visible in the distance, rising over the low skyline.

You can go south from here.

There is a Public Surveillance Notice here.

>climb trees
You've really got better things to do that trying to do that.

>l trees
That isn't interesting.

>l grass
Perfectly boring.

>l notice
A mounted sign which reads: PUBLIC SURVEILLANCE AREA.  ALL ACTIVITY MONITORED FOR HOMELAND SECURITY.

>l curfew sing
I only understood you as far as wanting to look the curfew sign.

>l curfew
A metal sign on a metal pole, it reads "NOTE: PARK CLOSED DURING RESIDENTIAL AREA CURFEW - 8:00PM to 5:00 AM - NO LOITERING."

>i
You are carrying:
  a backpack (being worn, and open but empty)
  a multitool
  a watch
  a phone

>wear watch
You put on the watch.

>l up
The sky is a deep blue, with colors fading into the reds towards the western horizon.

There is a quiet tone from your phone and you feel a short vibration, indicating that an SMS message has arrived.

>read phone
Message 1 reads: REPORT RECEIVED.  MISSION SUCCESSFUL.  ATTACK PROGRAM CREATED USING INFORMATION IN REPORT. <more>.

>g
Message 2 reads: DANGER DANGER DANGER:  OPERATIVE COMPROMISED DURING OPERATION.  YOUR MITKLEIN CODE READ BY HOMELAND SECURITY.  YOUR ID RECORDS DELETED BUT MITKLEIN CODE ALONE ENOUGH TO ID YOU AS TARGET.<more>.

>g
Message 3 reads: NEW INSTRUCTIONS FOLLOW: <more>.

>g
Message 4 reads: - YOU MUST FIND A WAY TO DISABLE YOUR MITKLEIN USING ATTACK PROGRAM WHICH WILL BE DELIVERED<more>.

>g
Message 5 reads: - YOU MUST NOT BE IN SURVEILLED AREA DURING CURFEW WITH ACTIVE MITKLEIN OR SECURITY SWEEPS WILL IDENTIFY YOU AS TARGET<more>.

>g
Message 6 reads: - YOU MUST NOT BE ID-SCANNED UNTIL MITKLEIN IS DISABLED<more>.

>g
Message 7 reads: - ONCE MITKLEIN IS DISABLED, RETRIEVE DROP MESSAGE FOR NEW INSTRUCTIONS.  CONTACT WILL LEAVE DROP MESSAGE NEAR FOUNTAIN IN GREEN COMMERCIAL.<more>.

>g
Message 8 reads: - ATTACK PROGRAM AVAILABLE FOR DOWNLOAD BY NETBOOTING ANY COMPUTER WITH YOUR PHONE IN PROXIMITY<more>.

>g
Message 9 reads: - THIS PHONE POSSIBLY COMPROMISED - IF IT ACQUIRES NEW CELL SIGNAL IT MAY BE LOCATED BY HOMELAND SECURITY<more>.

>g
Message 10 reads: GOOD LUCK. MESSAGE ENDS..

>l
Green Residential Park
Primrose Street ends here in a small circular cul-de-sac.  You're in a small green park to the north of this, bounded on its three other sides by high fences.  A few trees rise over well-manicured grass.  There is a curfew sign at the park's entrance.

The Reserve Bank Spacescraper is visible in the distance, rising over the low skyline.

You can go south from here.

There is a Public Surveillance Notice here.

>s
Primrose & Cedar
This staid neighborhood intersection of Primrose Lane and Cedar Street fronts the local Transit station, Green Residential.  The station entrance is to the west.  Primrose Lane continues to the south, and Cedar Street continues to the east.

The Reserve Bank Spacescraper is visible in the distance, rising over the low skyline.

You can go north to Green Residential Park, south, east, and west from here.

There is a Public Surveillance Notice here.

>e
East Cedar Street
Cedar Street comes to an end in a cul-de-sac here.  There are residential buildings to the north, east and south.  Typical for the area, they are three-family houses with common entrances.  Their lawns are neatly trimmed.

The Reserve Bank Spacescraper is visible in the distance, rising over the low skyline.

You can go west to Primrose & Cedar from here.

There is a Public Surveillance Notice here.

>l lawns
A set of extremely boring residential buildings with neatly trimmed lawns.

>enter houses
That's not something you can enter.

>w
Primrose & Cedar
This staid neighborhood intersection of Primrose Lane and Cedar Street fronts the local Transit station, Green Residential.  The station entrance is to the west.  Primrose Lane continues to the south, and Cedar Street continues to the east.

The Reserve Bank Spacescraper is visible in the distance, rising over the low skyline.

You can go north to Green Residential Park, south, east to East Cedar Street, and west from here.

There is a Public Surveillance Notice here.

>s
South Primrose Lane
Primrose Lane continues to the north.  To the south is a boarded-up empty house; sumac plants can be seen peeking over the top of the dilapidated fencing.  The fence has a plastic tarp strung behind it which prevents you from seeing much of the house.  To the west is a single-family home with a large warning sign and an enormous dog on the front lawn.  To the east is a three-family residence's front path.

The Reserve Bank Spacescraper is visible in the distance, rising over the low skyline.

You can go north to Primrose & Cedar and east from here.

There is a Public Surveillance Notice here.

>w
As you approach the lawn of the house, the large dog raises its head to look at you and growls, softly but very communicatively.  You decide discretion is the better part of valor and retreat.

>read sign
It reads "YOUR SKIN MUST BE THIS THICK (here there is a lifelike picture of a dog's tooth, perhaps an inch long) TO BURGLE THIS HOUSE."  There is an arrow pointing down and to the side, which actually points at the dog.

>w
As you approach the lawn of the house, the large dog raises its head to look at you and growls, softly but very communicatively.  You decide discretion is the better part of valor and retreat.

You have the sudden feeling that you're being followed.

>look lawn
You can't see any such thing.

>look east
You see nothing unexpected in that direction.

* * *

>l grass
Just what you'd expect.

>g
You examine the grass btu find nothing of interest.

* * *

>s
Primrose & Cedar
This staid neighborhood intersection of Primrose Lane and Cedar Street fronts the local Transit station, Green Residential.  The station entrance is to the west.  Primrose Lane continues to the south, and Cedar Street continues to the east.

The Reserve Bank Spacescraper is visible in the distance, rising over the low skyline.

You can go north to Green Residential Park, south, east, and west from here.

There is a Public Surveillance Notice here.

>s
South Primrose Lane
Primrose Lane continues to the north.  To the south is a boarded-up empty house; sumac plants can be seen peeking over the top of the dilapidated fencing.  The fence has a plastic tarp strung behind it which prevents you from seeing much of the house.  To the west is a single-family home with a large warning sign and an enormous dog on the front lawn.  To the east is a three-family residence's front path.

The Reserve Bank Spacescraper is visible in the distance, rising over the low skyline.

You can go north to Primrose & Cedar and east from here.

There is a Public Surveillance Notice here.

>e
Front Path
This front path is paved with cracked flagstones.  Primrose Lane is to the west, a three-family building is to the east, and the building's side yard is to the northeast.

The Reserve Bank Spacescraper is visible in the distance, rising over the low skyline.

You can go northeast, east through the House door (closed), and west to South Primrose Lane from here.

There is a Public Surveillance Notice here.

* * *

>ne
Side Yard
A narrow side yard with a high solid fence on the north side and a few straggly decorative plants.  The yard extends east behind the house and west to the front of the house.

The Reserve Bank Spacescraper is visible in the distance, rising over the low skyline.

You can go east and west to Front Path from here.

There is a Public Surveillance Notice here.

There is a quiet tone from your phone and you feel a short vibration, indicating that an SMS message has arrived.

>se
You can't go that way.

>e
Back Yard
An enclosed back yard, this small square of grass is surrounded by a high fence and the east side of the attached home.  A narrow frosted window - likely a bathroom - is visible in the middle of the stretch of wall, and a larger clear window with curtains behind it is visible at the south end.

The Reserve Bank Spacescraper is visible in the distance, rising over the low skyline.

You can go north to Side Yard from here.

There is a Public Surveillance Notice here.

>l grass
You examine Yardgrass but find nothing of interest.

>rules
Rules tracing now switched on. Type "rules off" to switch it off again, or "rules all" to include even rules which do not apply.

>kick yardgrass
[Rule "Instead of doing something other than examining or taking unimportant stuff" applies.]
You've really got better things to do that trying to do that.

[Rule "Every Turn during Transit Enroute" applies.]

* * *

>kick dog
You can't see any such thing.

* * *

>rules
Rules tracing now switched on. Type "rules off" to switch it off again, or "rules all" to include even rules which do not apply.

>kick dog
[Rule "Check attacking the large dog" applies.]
Uh…you really, REALLY don't want to try that.

[Rule "Every Turn during Transit Stop" applies.]
[Rule "scene description text rule" applies.]

* * *

>rules off
Rules tracing now switched off. Type "rules" to switch it on again.

>rules
Rules tracing now switched on. Type "rules off" to switch it off again, or "rules all" to include even rules which do not apply.

>kick sign
[Rule "block attacking rule" applies.]
Violence isn't the answer to this one.

[Rule "Every Turn during Transit Enroute" applies.]
A tiny surveillance camera you're sure you didn't see before swivels to follow you.

>actions
Actions listing on.

>kick sign
[attacking the warning sign]
[Rule "block attacking rule" applies.]
Violence isn't the answer to this one.
[attacking the warning sign - failed the block attacking rule]

[Rule "Every Turn during Transit Enroute" applies.]

>rules
Rules tracing now switched on. Type "rules off" to switch it off again, or "rules all" to include even rules which do not apply.

>w
[Rule "standard set going variables rule" applies.]
[going west]
[Rule "Instead of going west in South Primrose Lane" applies.]
As you approach the lawn of the house, the large dog raises its head to look at you and growls, softly but very communicatively.  You decide discretion is the better part of valor and retreat.
[going west - failed]

[Rule "Every Turn during Transit Enroute" applies.]
[Rule "scene description text rule" applies.]

>wear watch
[wearing the watch]
[Rule "can't wear what's not clothing rule" applies.]
[Rule "can't wear what's not held rule" applies.]
[Rule "can't wear what's already worn rule" applies.]
[Rule "Carry out wearing the watch" applies.]
[Rule "standard wearing rule" applies.]
[Rule "standard report wearing rule" applies.]
You put on the watch.
[wearing the watch - succeeded]

[Rule "Every Turn during Transit Stop" applies.]

* * *

>l lawn
That isn't interesting.

>w
As you approach the lawn of the house, the large dog raises its head to look at you and growls, softly but very communicatively.  You decide discretion is the better part of valor and retreat.

>take lawn
You can't do that.

>l lawn
That isn't interesting.

>l lawn
Perfectly boring.

>l lawn
That isn't interesting.

>kick dog
Uh…you really, REALLY don't want to try that.

There is a quiet tone from your phone and you feel a short vibration, indicating that an SMS message has arrived.

>kick dog
Uh…you really, REALLY don't want to try that.

>attack dog
Uh…you really, REALLY don't want to try that.

>actions
Actions listing on.

>kick dog
[attacking the large dog]
Uh…you really, REALLY don't want to try that.
[attacking the large dog - failed the Check attacking the large dog]

>attack dog
[attacking the large dog]
Uh…you really, REALLY don't want to try that.
[attacking the large dog - failed the Check attacking the large dog]

>punch dog
[attacking the large dog]
Uh…you really, REALLY don't want to try that.
[attacking the large dog - failed the Check attacking the large dog]

>actions off
Actions listing off.

>e
Front Path
This front path is paved with cracked flagstones.  Primrose Lane is to the west, a three-family building is to the east, and the building's side yard is to the northeast.

The Reserve Bank Spacescraper is visible in the distance, rising over the low skyline.

You can go northeast, east through the House door (closed), and west to South Primrose Lane from here.

There is a Public Surveillance Notice here.

You have the sudden feeling that you're being followed.

A quiet tone from your phone indicates that you have unread SMS messages.

>read messages
Message 1 reads: REPORT RECEIVED.  MISSION SUCCESSFUL.  ATTACK PROGRAM CREATED USING INFORMATION IN REPORT. <more>.

>g
Message 2 reads: DANGER DANGER DANGER:  OPERATIVE COMPROMISED DURING OPERATION.  YOUR MITKLEIN CODE READ BY HOMELAND SECURITY.  YOUR ID RECORDS DELETED BUT MITKLEIN CODE ALONE ENOUGH TO ID YOU AS TARGET.<more>.

* * *

>g
Message 10 reads: GOOD LUCK. MESSAGE ENDS..

>ne
Side Yard
A narrow side yard with a high solid fence on the north side and a few straggly decorative plants.  The yard extends east behind the house and west to the front of the house.

The Reserve Bank Spacescraper is visible in the distance, rising over the low skyline.

You can go east and west to Front Path from here.

There is a Public Surveillance Notice here.

* * *

>don watch
You put on the watch.

>doff watch
You take off the watch.

>don watch
You put on the watch.

>rules
Rules tracing now switched on. Type "rules off" to switch it off again, or "rules all" to include even rules which do not apply.

* * *

>wear watch
You put on the watch.

>s
Primrose & Cedar
This staid neighborhood intersection of Primrose Lane and Cedar Street fronts the local Transit station, Green Residential.  The station entrance is to the west.  Primrose Lane continues to the south, and Cedar Street continues to the east.

The Reserve Bank Spacescraper is visible in the distance, rising over the low skyline.

You can go north to Green Residential Park, south, east, and west from here.

There is a Public Surveillance Notice here.

* * *

>e
Front Path
This front path is paved with cracked flagstones.  Primrose Lane is to the west, a three-family building is to the east, and the building's side yard is to the northeast.

The Reserve Bank Spacescraper is visible in the distance, rising over the low skyline.

You can go northeast, east through the House door (closed), and west to South Primrose Lane from here.

There is a Public Surveillance Notice here.

There is a quiet tone from your phone and you feel a short vibration, indicating that an SMS message has arrived.

>e
(first opening the House door)

Front Lobby
The slightly shabby front lobby of this multi-family building.  A door leads outside to the west, gated stairs leading up to the upper two floors are to the east, and an apartment door is to the south.

A small post-it note is stuck to the door of Apartment 1.

You can also see a newspaper and a pamphlet here.

You can go south through the Apartment door (closed) and west through the House door to Front Path from here.

The automatic door slides closed.

>put newspaper and pamphlet in pack
newspaper: Done.
pamphlet: Done.

>read post-it
A short scribble, which reads "The techs were by to turn off your water.  Have a nice vacation!"

>w
(first opening the House door)

Front Path
This front path is paved with cracked flagstones.  Primrose Lane is to the west, a three-family building is to the east, and the building's side yard is to the northeast.

The Reserve Bank Spacescraper is visible in the distance, rising over the low skyline.

You can go northeast, east through the House door to Front Lobby, and west to South Primrose Lane from here.

There is a Public Surveillance Notice here.

The automatic door slides closed.

>ne
Side Yard
A narrow side yard with a high solid fence on the north side and a few straggly decorative plants.  The yard extends east behind the house and west to the front of the house.

The Reserve Bank Spacescraper is visible in the distance, rising over the low skyline.

You can go east and west to Front Path from here.

There is a Public Surveillance Notice here.

>e
Back Yard
An enclosed back yard, this small square of grass is surrounded by a high fence and the east side of the attached home.  A narrow frosted window - likely a bathroom - is visible in the middle of the stretch of wall, and a larger clear window with curtains behind it is visible at the south end.

The Reserve Bank Spacescraper is visible in the distance, rising over the low skyline.

You can go north to Side Yard from here.

There is a Public Surveillance Notice here.

>l bedroom window
A large clear two-pane window, it is locked with a latch mechanism at the join of the two panes.

>l latch
This is a fairly standard window latch.  It prevents the two windowpanes from sliding past one another.  The locking tab is secured with a cotter pin which, for some reason, is on the outside of the window.

In the latch is a cotter pin.

>remove cotter pin
You can't get enough purchase with your fingers to pull it out.

A quiet tone from your phone indicates that you have unread SMS messages.

>remove cotter pin with multitool
You deftly remove the cotter pin with the multitool.

>drop pin
Dropped.

>read SMS
Message 1 reads: REPORT RECEIVED.  MISSION SUCCESSFUL.  ATTACK PROGRAM CREATED USING INFORMATION IN REPORT. <more>.

>g
Message 2 reads: DANGER DANGER DANGER:  OPERATIVE COMPROMISED DURING OPERATION.  YOUR MITKLEIN CODE READ BY HOMELAND SECURITY.  YOUR ID RECORDS DELETED BUT MITKLEIN CODE ALONE ENOUGH TO ID YOU AS TARGET.<more>.

* * *

>g
Message 10 reads: GOOD LUCK. MESSAGE ENDS..

>open bedroom window
You slide the bedroom window open.

>enter bedroom window
Bedroom
This bedroom is rather boring.  Its owners must not spend much time in it while awake.  It contains a bed - currently unmade - and a bedside table with a lamp on it.

You can go north, east to Back Yard, and west from here.

>w
Hall
The central hallway of this modest home.  It's relatively clean and neat, as there is no furniture in it.

You can go north, east to Bedroom, and west from here.

>n
Entry
This is the small entryway to the ground-floor apartment. A pile of mail, most of it unread, nearly covers the side table just inside the apartment door.  The apartment hallway is to the south.  To the west is an office, and to the east is a bathroom.

You can see a side table (on which is a car key) here.

You can go north through the Apartment door (closed) to Front Lobby, south to Hall, east, and west from here.

>take key
Taken.

>w
Home Office
This is obviously a home office, a room which in other homes might be a living room. It is not very tidy.  Random detritus covers most available surfaces except for a workbench.

You can see a workbench (on which are a lockblade knife, a soldering iron, some solder, and a laptop) here.

You can go south and east to Entry from here.

>take knife and iron and solder
lockblade knife: This knife is large enough to run afoul of local weapons laws.  It would be a bad idea to let it be seen where the police are watching.
soldering iron: Taken.
solder: (putting the phone into the backpack to make room)
Taken.

>reboot laptop
The screen flickers as the laptop reboots.  The laptop pauses as it finds the boot server that has been installed on your phone, and then there is a quick series of flashes before a screen full of text comes up!

>open key with knife
You carefully cut open the car key with your knife and peel back the rubber to reveal a broadcast chip and a blank memory chip.

>take broadcast and memory
broadcast chip: (putting the multitool into the backpack to make room)
Taken.
blank memory chip: (putting the car key into the backpack to make room)
Taken.

>put memory in chipslot
The Download light flashes red intermittently for a few seconds before returning to a regular blinking green.

* * *

>take memory
Taken.

>put laptop in pack
You put the laptop into the backpack.

>combine broadcast and memory
You switch the soldering iron on.

You fashion the broadcast chip and the attack memory chip into a Klein Blaster!

>turn iron off
You switch the soldering iron off.

>put iron and solder in pack
soldering iron: Done.
solder: Done.

>s
Kitchen
This kitchen is decorated in a style some four decades old, which is probably when it was last renovated.  It is fairly clean, likely reflecting the fact that the occupants don't cook for themselves much.

You can see a thermos (closed), a refrigerator (closed), and a microwave oven here.

You can go north to Home Office and east to Hall from here.

>put thermos in pack
You put the thermos into the backpack.

>open side panel with multitool
You pry open the side panel with the pliers in your multitool, ignoring the sound of breaking plastic.

>microwave phone
You open the oven.

You put the phone into the oven.

A light comes on in the microwave and it begins to hum.
Almost immediately, sparks begin to dance wildly around the rim of the phone! After a few seconds more, the screen goes dead black with a very final ZZT noise.
A few moments later there is a loud BING! and the microwave stops.

>open oven
You open the oven.

* * *

>take phone
Taken.

>put klein blaster in side panel
You insert the Klein Blaster into the side panel and wire it to the magnetron by rewiring the circuit board slightly.
As you slide the component in, a small LED labelled "TRNSMT RDY" lights up on the board!

>push microwave button
With the door open, the hacked microwave keeps increasing its power as energy is lost to the air.  You feel an incredible burst of noise behind your forehead!  Static, bits of music, and above all the shriek of data transfer!  Just before you feel you'll go mad from the noise, there is a stutter, and it stops.  Blessed silence falls inside your skull.  There is a smell of smoke as the microwave goes dead.

>put knife in pack
You put the lockblade knife into the backpack.

>n
Home Office
This is obviously a home office, a room which in other homes might be a living room. It is not very tidy.  Random detritus covers most available surfaces except for a workbench.

You can see a workbench here.

You can go south to the Kitchen and east to Entry from here.

>e
Entry
This is the small entryway to the ground-floor apartment. A pile of mail, most of it unread, nearly covers the side table just inside the apartment door.  The apartment hallway is to the south.  To the west is an office, and to the east is a bathroom.

You can see a side table here.

You can go north through the Apartment door (closed) to Front Lobby, south to Hall, east, and west to Home Office from here.

>n
(first opening the Apartment door)
You undo the throw bolts.  Since you have no key, you leave the door unlocked.

Front Lobby
The slightly shabby front lobby of this multi-family building.  A door leads outside to the west, gated stairs leading up to the upper two floors are to the east, and an apartment door is to the south.

A small post-it note is stuck to the door of Apartment 1.

You can go south through the Apartment door to Entry and west through the House door (closed) to Front Path from here.

>w
(first opening the House door)

Front Path
This front path is paved with cracked flagstones.  Primrose Lane is to the west, a three-family building is to the east, and the building's side yard is to the northeast.

The Reserve Bank Spacescraper is visible in the distance, rising over the low skyline.

You can go northeast to Side Yard, east through the House door to Front Lobby, and west to South Primrose Lane from here.

There is a Public Surveillance Notice here.

You have the sudden feeling that you're being followed.

The automatic door slides closed.

>w
South Primrose Lane
Primrose Lane continues to the north.  To the south is a boarded-up empty house; sumac plants can be seen peeking over the top of the dilapidated fencing.  The fence has a plastic tarp strung behind it which prevents you from seeing much of the house.  To the west is a single-family home with a large warning sign and an enormous dog on the front lawn.  To the east is a three-family residence's front path.

The Reserve Bank Spacescraper is visible in the distance, rising over the low skyline.

You can go north to Primrose & Cedar and east to Front Path from here.

There is a Public Surveillance Notice here.

>n
Primrose & Cedar
This staid neighborhood intersection of Primrose Lane and Cedar Street fronts the local Transit station, Green Residential.  The station entrance is to the west.  Primrose Lane continues to the south, and Cedar Street continues to the east.

The Reserve Bank Spacescraper is visible in the distance, rising over the low skyline.

You can go north to Green Residential Park, south to South Primrose Lane, east, and west from here.

There is a Public Surveillance Notice here.

>w
Green Residential Station
This is a utilitarian (read: boring) facility intended mostly to keep the rain out of the Transit System.  A stairway leads down to the Transit platform and an exit leads east to the street.

You can go east to Primrose & Cedar and down through the Green Residential Station door (closed) from here.

There is a Public Surveillance Notice here.

I beg your pardon?

>d
(first opening the Green Residential Station door)
The Door Scanner scans your iris to determine your identity.  The Transit Security and Accounting Subroutine determines that you have a legitimate account with the Transit system, and the doors slide smoothly open.

Green Residential Platform
Green Residential's platform serves mostly residential commuters.  There is an exit at the center of the platform which leads east through a set of closed automatic doors to a stairway leading up to the main station, just next to a large plaque with the name of the station on it.  The platform abuts the Transit web to the west, where a Transit capsule hovers impatiently.  The capsule doors are open.

You can see a Transit Map here.

You can go east through the Green Residential Station door to Green Residential Station from here.

There is a Public Surveillance Notice here.

A few commuters get on and off the Transit capsule.

The automatic door slides closed.

>z
Time passes.

A few commuters get on and off the Transit capsule.

The capsule doors slide shut.  The humming noice increases in volume, and the capsule slides out of the station, gathering speed as it goes, and slides into the tunnel.

>wait for capsule
You see a small mouse scurry along the Transit Web and vanish back into the tunnels.

A public address system reminds you to be alert and "if you see something, say something!"

You see a small red light in the corner of your vision which vanishes as you turn to look at it.

A public address system reminds you to be alert and "if you see something, say something!"

A light grows in the tunnel.  With a deep thrumming and the whoosh of displaced air, the Transit Capsule slides smoothly into Green Residential Platform and comes to a stop, hovering in the Web.  The doors slide open and a few commuters enter and exit the capsule.
The Capsule has arrived.  The time is 8:32 pm.
A few commuters get on and off the Transit capsule.

>enter capsule
You move into the Transit Capsule.

Transit Capsule
A fifty-person maglev Transit capsule.  You're standing, holding on to a strap.  Through the windows you can see the Green Residential Platform.

There is a Public Surveillance Notice here.

A few commuters get on and off the Transit capsule.

>z
Time passes.

A few commuters get on and off the Transit capsule.

The capsule doors slide shut.  The humming noice increases in volume, and the capsule slides out of the station, gathering speed as it goes, and slides into the tunnel.
You hold onto your strap as the Capsule rapidly accelerates.

>z
Time passes.

>z
Time passes.

A nearby commuter's handheld begins beeping loudly.  She hurriedly shuts it off.

>z
Time passes.

Someone coughs.

A tiny surveillance camera you're sure you didn't see before swivels to follow you.

With a deep thrumming and the whoosh of displaced air, the Transit Capsule slides smoothly into Green Service Platform and comes to a stop, hovering in the Web.  The doors slide open and a few commuters enter and exit the capsule.

>z
Time passes.

A few commuters get on and off the Transit capsule.

>exit
Green Service Platform
Green Service One's platform is underground.  It serves mostly city workers during the day.  There is an exit at the center of the platform which leads north through a set of closed automatic doors to a stairway leading up to the main station, just next to a large plaque with the name of the station on it.  The platform abuts the Transit web to the south, where a Transit capsule hovers impatiently in the web.  The capsule doors are open.

You can see a Transit Map here.

You can go north through the Green Service Station door (closed) from here.

There is a Public Surveillance Notice here.

A few commuters get on and off the Transit capsule.

>n
(first opening the Green Service Station door)

Green Service Station
Green Service is the local government services cluster.  The Transit station seems to reflect this, exhibiting a weary conformity - although you couldn't say exactly how.  A stairway leads down to the platform access doors, and a set of doorways lead north out onto Government Square.

You can go north and down through the Green Service Station door to Green Service Platform from here.

There is a Public Surveillance Notice here.

The automatic door slides closed.

* * *

>n
Government Square North
The north half of Government Square is surrounded on three sides by roadway.  Groundcars trundle back and forth, and the occasional flitter whines down to or screams up from flitter pads near the buildings across it.  The hospital driveway is to the southeast, across the road; the hospital entrance to the east and the police station to the west.  To the north is the steps to the Civil Center, the local government office building.

The Reserve Bank Spacescraper is visible in the distance, rising over the low skyline.

It seems a tourist has left behind a cheap disposable camera, which rests on the sidewalk here.

You can go north, south to Government Square South, southeast, east, and west from here.

There is a Public Surveillance Notice here.

>put lost camera in pack
You put the lost camera into the backpack.

>n
Civil Center Steps
These are the front steps of an impressive government building.  Civil servants hurry in and out through the security checkpoint, going about their business.

The Reserve Bank Spacescraper is visible in the distance, rising over the low skyline.

You can also see Ponyfriend Chunky and the civil servants here.

You can go south to Government Square North from here.

There is a Public Surveillance Notice here.

>ponyfriend, tell me about the pager
Ponyfriend responds out of the corner of his mouth, looking away. "Oh, my pager, yes.  This is how They send me my mission briefings. Well, what I mean is, they page me and I call them to get the briefings, yes.  I'm sorry, I have to keep checking to make sure they haven't paged me.  I wish…I wish I could talk to them directly, though.耀"

>ponyfriend, tell me about your missions
Ponyfriend shrugs and replies. "My missions?  They're…well…(a suspicious look comes over his face) They're secret! You can't know!"

>ponyfriend, give me the pager
Ponyfriend looks frightened and clutches the pager to his chest.  "No! You can't have it!  THEY gave it to me! How would I know They needed me if I gave it to you?"

>offer phone to ponyfriend
(Ponyfriend Chunky)
Ponyfriend clutches the cell phone and mumbles "This is so much better, now I can get my instructions directly rather than having to call them back!"  He stands there for a moment, then seems to come to a realization.  "In fact, they can call me!  I don't need this pager!" he says.

Ponyfriend Chunky gives the pager to you.

>open pager
You open the pager, revealing a receive chip.

Ponyfriend furtively scratches underneath his none-too-clean shirt.

>put receive chip in key
You put the receive chip into the car key.

Ponyfriend checks his cell phone, looking disappointed that no-one has called.

>put pager in pack
You put the pager into the backpack.

>s
Government Square North
The north half of Government Square is surrounded on three sides by roadway.  Groundcars trundle back and forth, and the occasional flitter whines down to or screams up from flitter pads near the buildings across it.  The hospital driveway is to the southeast, across the road; the hospital entrance to the east and the police station to the west.  To the north is the steps to the Civil Center, the local government office building.

The Reserve Bank Spacescraper is visible in the distance, rising over the low skyline.

You can go north to Civil Center Steps, south to Government Square South, southeast, east, and west from here.

There is a Public Surveillance Notice here.

>e
Hospital Entrance
This is the front entryway pavilion of the local hospital.  The automatic entryway doors are to the east, and the ER entrance and driveway is to the south.

The Reserve Bank Spacescraper is visible in the distance, rising over the low skyline.

You can go south, southwest to Government Square South, east through the Hospital door (closed), and west to Government Square North from here.

There is a Public Surveillance Notice here.

>e
(first opening the Hospital door)

Hospital Lobby
This is the main entrance to a busy regional hospital.  Patients and staff rush back and forth, all too busy to pay you any attention.  To the south is an archway with a sign reading "TRIAGE"; to the east is the elevator core and to the north is the waiting lounge.

You can go north, south, east, and west through the Hospital door to Hospital Entrance from here.

There is a Public Surveillance Notice here.

The automatic door slides closed.

>n
Hospital Lounge
This lounge is full of marginally-comfortable seating and antiquated magazines.  A door to the east reads "LAB" and the main lobby is to the south.

You can go south to Hospital Lobby and east from here.

>e
Hospital Lab
This is an all-purpose pathology laboratory receiving area.  The lab itself is behind a bulletproof glass wall to the east, and a small window allows samples or paperwork to be passed back and forth.

You can see a cryopack (closed) and a trash can (closed) here.

You can go west to Hospital Lounge from here.

There is a Public Surveillance Notice here.

* * *

>take cryopack
Taken.

>w
Hospital Lounge
This lounge is full of marginally-comfortable seating and antiquated magazines.  A door to the east reads "LAB" and the main lobby is to the south.

You can go south to Hospital Lobby and east to the Hospital Lab from here.

>s
Hospital Lobby
This is the main entrance to a busy regional hospital.  Patients and staff rush back and forth, all too busy to pay you any attention.  To the south is an archway with a sign reading "TRIAGE"; to the east is the elevator core and to the north is the waiting lounge.

You can go north to Hospital Lounge, south, east, and west through the Hospital door (closed) to Hospital Entrance from here.

There is a Public Surveillance Notice here.

>e
Hospital Elevators
The main elevator bank for the hospital seems to require either an appropriate Mit-Klein scan or a hospital ID to swipe.  The lobby is to the west.  The ER is through a door to the south, and a restroom is to the east.

You can go south, east, and west to Hospital Lobby from here.

There is a Public Surveillance Notice here.

>e
Hospital Restroom
A clean restroom that smells strongly of disinfectant and hand sanitizer.  There is a single sink with a small mirror over it and a single stall.

You can see a trash can (closed) here.

You can go west to Hospital Elevators from here.

>open solar panel with tool
You pry open the solar panel with the pliers in your multitool, ignoring the sound of breaking plastic.
 Opening the solar panel reveals the broadcast chip!

>put broadcast chip in pack
You put the broadcast chip into the backpack.

>w
Hospital Elevators
The main elevator bank for the hospital seems to require either an appropriate Mit-Klein scan or a hospital ID to swipe.  The lobby is to the west.  The ER is through a door to the south, and a restroom is to the east.

You can go south, east to Hospital Restroom, and west to Hospital Lobby from here.

There is a Public Surveillance Notice here.

>s
Emergency Room
This is a prep and emergency treatment area for the emergency ward to the east, which is locked.  Triage is to the west, and a door leads north.

You can see a tissue generator here.

You can go north to Hospital Elevators and west from here.

There is a Public Surveillance Notice here.

You see a small red light in the corner of your vision which vanishes as you turn to look at it.

>open cryopack
A small cloud of chill and condensation escapes from the cryopack into the surrounding air.  The green LED on it goes out; a red one lights up.

You open the cryopack.

>put cryopack in sample slot
You put the cryopack into the sample slot.

>w
Triage
This is a triage area for the ER to the east.  To the north is the main Hospital lobby, and west lies the automatic doors out to the driveway.

You can go north to Hospital Lobby, east to the Emergency Room, and west through the ER door (closed) from here.

There is a Public Surveillance Notice here.

>w
(first opening the ER door)

Hospital Driveway
The driveway and parking area for the Hospital ER, which lies directly to the east.  To the north is the main entrance to the Hospital building.

The Reserve Bank Spacescraper is visible in the distance, rising over the low skyline.

An ambulance, a bulky flittervan with emergency markings, is parked here.

You can go north to Hospital Entrance, northwest to Government Square North, east through the ER door to Triage, and west to Government Square South from here.

There is a Public Surveillance Notice here.

The automatic door slides closed.

>open ambulance
As you reach for the door handle, the locklarm begins to strobe and an ominous beeping begins.  You decide not to risk it.

>w
Government Square South
This is the southern half of Government Square.  Several benches and landscape features are scattered throughout the area.  A roadway approaches from the west, loops north around the square and continues to the east.  Groundcars move back and forth along the road, mixed with official vehicles such as police cars, ambulances and the ubiquitous slightly shabby black flitters used by government agencies.  The doors to Green Service Transit station are to the south.  Across the road to the east is Green Hospital's driveway.  The Hospital's main entrance is to the northeast.  The square continues to the north.  To the northwest, across the road on the other side, is the front steps of the local police station.

The Reserve Bank Spacescraper is visible in the distance, rising over the low skyline.

You can go north to Government Square North, northeast to Hospital Entrance, northwest, south to Green Service Station, and east to Hospital Driveway from here.

There is a Public Surveillance Notice here.

>s
Green Service Station
Green Service is the local government services cluster.  The Transit station seems to reflect this, exhibiting a weary conformity - although you couldn't say exactly how.  A stairway leads down to the platform access doors, and a set of doorways lead north out onto Government Square.

You can go north to Government Square South and down through the Green Service Station door (closed) to Green Service Platform from here.

There is a Public Surveillance Notice here.

* * *

>wait for capsule
A commuter walks by.

Warning lights along the platform edge begin to blink rapidly.  A light grows in the tunnel.  With a deep moan and gust of wind, an express Transit Capsule blasts through Green Service One and vanishes into the darkness once more.

Warning lights along the platform edge begin to blink rapidly.  A light grows in the tunnel.  With a deep moan and gust of wind, an express Transit Capsule blasts through Green Service One and vanishes into the darkness once more.

A commuter walks by.

A light grows in the tunnel.  With a deep thrumming and the whoosh of displaced air, the Transit Capsule slides smoothly into Green Service Platform and comes to a stop, hovering in the Web.  The doors slide open and a few commuters enter and exit the capsule.
The Capsule has arrived.  The time is 9:26 pm.
A few commuters get on and off the Transit capsule.

>enter capsule
You move into the Transit Capsule.

Transit Capsule
A fifty-person maglev Transit capsule.  You're standing, holding on to a strap.  Through the windows you can see the Green Service Platform.

There is a Public Surveillance Notice here.

A few commuters get on and off the Transit capsule.

>z
Time passes.

A few commuters get on and off the Transit capsule.

The capsule doors slide shut.  The humming noice increases in volume, and the capsule slides out of the station, gathering speed as it goes, and slides into the tunnel.
You hold onto your strap as the Capsule rapidly accelerates.

* * *

>z
Time passes.

With a deep thrumming and the whoosh of displaced air, the Transit Capsule slides smoothly into Reserve Bank Station and comes to a stop, hovering in the Web.  The doors slide open and a few commuters enter and exit the capsule.

>z
Time passes.

A few commuters get on and off the Transit capsule.

>z
Time passes.

A few commuters get on and off the Transit capsule.

>z
Time passes.

A few commuters get on and off the Transit capsule.

The capsule doors slide shut.  The humming noice increases in volume, and the capsule slides out of the station, gathering speed as it goes, and slides into the tunnel.
You hold onto your strap as the Capsule rapidly accelerates.

* * *

>z
Time passes.

With a deep thrumming and the whoosh of displaced air, the Transit Capsule slides smoothly into Green Commercial Platform and comes to a stop, hovering in the Web.  The doors slide open and a few commuters enter and exit the capsule.

>z
Time passes.

A few commuters get on and off the Transit capsule.

>exit
Green Commercial Platform
Green Commercial One is one of the oldest stations on the Transit web.  Although it has been refurbished several times, its age still manages to show through the layers of tile and paint.  The platform opens out at the middle to a lobby area which is dominated by a row of automated doors to the south, which lead to stairways up to the main station.  The flow of commuters moves steadily through these doors.  The floor and walls are both extremely scuffed duramex nanotile, and the station name (Green Commercial One) is indicated on a large plaque set into the walls. The platform abuts the Transit web to the north, where a Transit capsule can be seen hovering.  The capsule doors are open.

You can see a Transit Map here.

You can go south through the Green Commercial Station door (closed) from here.

There is a Public Surveillance Notice here.

A few commuters get on and off the Transit capsule.

* * *

>s
Green Commercial Plaza North
Green Commercial One is built around a plaza, and this is its northern end.  No vehicles are permitted within the public areas of Green Commercial One, so the entire area is pedestrian-only.  To the north are the doorways to the Green Commercial Station.  To the east is the NanoMart.  To the west is a storefront bank with an ATM.  The plaza continues to the south.

The Reserve Bank Spacescraper is visible in the distance, rising over the low skyline.

You can also see a trash can (closed) here.

You can go north to Green Commercial Station, south, southeast, southwest, east, and west from here.

There is a Public Surveillance Notice here.

>s
Green Commercial Plaza Center
This is the center of the Green Commercial Plaza.  There is a fountain here with a bench facing it.  The plaza continues to the north and south; to the east is a bar called (ironically, you hope) the Proletariat.  To the west is a Bistro Paris cafe.

The Reserve Bank Spacescraper is visible in the distance, rising over the low skyline.

You can also see a trash can (closed) here.

You can go north to Green Commercial Plaza North, northeast, northwest, south, southeast, east, and west from here.

There is a Public Surveillance Notice here.

>s
Green Commercial Plaza South
The southern end of the Green Commercial Plaza, which continues to the north.  To the east is Accessorize, a fashion store, and to the west is Garb-oh, a trendy clothing shop.  The south end of the mall is closed off by an elaborate landscaping installation of trees and shrubs, presumably to hide a relatively ugly building behind it.

The Reserve Bank Spacescraper is visible in the distance, rising over the low skyline.

You can also see a trash can (closed) here.

You can go north to Green Commercial Plaza Center, northeast, northwest, east, and west through the Garb-oh door (closed) from here.

There is a Public Surveillance Notice here.

* * *

>take red jacket
Taken.

>x shopper
 The shopper is a young woman wearing large headphones, loose clothes. She is bouncing her head in what is probably the rhythm of the song she is listening to, and seems to be paying very little attention to her surroundings.  Every once in a while she pulls an item from a rack and holds it up in front of a mirror before returning it to its place.  She is wearing a large shoulder bag.

The shopper is empty-handed.

>put red jacket in shoulder bag
You stealthily slide the red jacket into the shoulder bag!

The shopper puts down a last item of clothing and drifts towards the door.  As she reaches it, however, the antitheft alarm blares and a strobe light begins to flash!  She stops, frozen in surprise, as the shopkeeper rushes over and grabs her.  A few seconds later, two policemen enter the shop.  The shopkeeper, shopper and police all begin shouting at the same time.

>n
You move around behind the sales counter.

Garb-oh (in the sales counter)
Garb-oh! is a trendy clothing shop.  Images of the shop's icon Greta Garbo abound, each dressed in the clothing item offered on the rack below it.  Jackets, scarves, bandannas, trousers, shirts and more are on inviting display.

On the racks are a blue jacket, a white shirt, a green shirt, a blue pair of pants, and a brown pair of pants.

You can also see a Patrolman, Officer Prescott, the shopkeeper, and the shopper here.

There is a wide drawer below the counter level.

You can go east through the Garb-oh door (closed) to Green Commercial Plaza South from here.

There is a Public Surveillance Notice here.

>open drawer
You open the sales drawer, revealing a tag remover.

>take tag remover
Taken.

>s
You move out from behind the sales counter.

Garb-oh
Garb-oh! is a trendy clothing shop.  Images of the shop's icon Greta Garbo abound, each dressed in the clothing item offered on the rack below it.  Jackets, scarves, bandannas, trousers, shirts and more are on inviting display.

On the racks are a blue jacket, a white shirt, a green shirt, a blue pair of pants, and a brown pair of pants.

The sales counter runs along the north side of the store.

You can also see a Patrolman, Officer Prescott, the shopkeeper, and the shopper here.

You can go east through the Garb-oh door (closed) to Green Commercial Plaza South from here.

There is a Public Surveillance Notice here.

>take blue jacket
Taken.

>remove blue jacket's antitheft tag
(first taking the blue jacket's antitheft tag)
What do you want to remove that with?

>remove blue jacket's antitheft tag with tag remover
You deftly remove the tag with the tag remover.

>put blue jacket in pack
You put the blue jacket into the backpack.

The police finally search the shopper's shoulder bag, and shake their heads.  They lead her towards the door, one explaining that they'll need to take her statement at the station.  The shopkeeper asks snippily what they'll be doing to protect her stock; Officer Prescott rolls his eyes and says "Lady, we'll have our patrol stop in the plaza out front for a while in case this one has any accomplices, all right?"  They leave, and the shopkeeper watches them go with a somewhat irritatingly smug expression on her face.

>open thermos
You open the thermos.

>put blue jacket's antitheft tag in thermos
You put the blue jacket's antitheft tag into the thermos.

>remove white shirt's antitheft tag with tag remover
You deftly remove the tag with the tag remover.

>remove green shirt's antitheft tag with tag remover
You deftly remove the tag with the tag remover.

>put white shirt's antitheft tag in thermos
You put the white shirt's antitheft tag into the thermos.

>put green shirt's antitheft tag in thermos
You put the green shirt's antitheft tag into the thermos.

>close thermos
You close the thermos.

>i
You are carrying:
  a tag remover
  a backpack (being worn, and open)
    a blue jacket
    a broadcast chip
    a pager (open but empty)
    a lost camera
    a lockblade knife
    a thermos (closed)
    some solder
    a soldering iron
    a laptop
    a car key
      a receive chip
    a multitool
    a pamphlet
    a newspaper
  a watch (being worn)

>put tag remover in pack
You put the tag remover into the backpack.

>e
(first opening the Garb-oh door)

Green Commercial Plaza South
The southern end of the Green Commercial Plaza, which continues to the north.  To the east is Accessorize, a fashion store, and to the west is Garb-oh, a trendy clothing shop.  The south end of the mall is closed off by an elaborate landscaping installation of trees and shrubs, presumably to hide a relatively ugly building behind it.

The Reserve Bank Spacescraper is visible in the distance, rising over the low skyline.

You can also see a trash can (closed) here.

You can go north to Green Commercial Plaza Center, northeast, northwest, east, and west through the Garb-oh door to Garb-oh from here.

There is a Public Surveillance Notice here.

The automatic door slides closed.

>n
Green Commercial Plaza Center
This is the center of the Green Commercial Plaza.  There is a fountain here with a bench facing it.  The plaza continues to the north and south; to the east is a bar called (ironically, you hope) the Proletariat.  To the west is a Bistro Paris cafe.

The Reserve Bank Spacescraper is visible in the distance, rising over the low skyline.

You can also see a trash can (closed) here.

You can go north to Green Commercial Plaza North, northeast, northwest, south to Green Commercial Plaza South, southeast, east, and west from here.

There is a Public Surveillance Notice here.

>e
The Proletariat Bar
The Proletariat is a local bar (not a pub).  It's just far enough above a "dive" to be allowed zoning here, but steadfastedly refuses to cater to upscale tastes.  You like it.  Restrooms are to the east; the bar runs along the north side with a stolid bartender behind it and a jukebox sits against the back wall.  A few hardy drinkers sit here, communing with their spirits.  In a nod to the place's name, a Public Surveillance Notice covered with stickers and graffiti tags has been framed above the bar.

You can see Roberto Velez here.

You can go northwest to Green Commercial Plaza North, southwest to Green Commercial Plaza South, east, and west to Green Commercial Plaza Center from here.

There is a Public Surveillance Notice here.

>e
Proletariat Restroom
The one-holer restroom at the Proletariat is cleaner than you might think, although that may be due to the fact that it is midweek.  A scratched mirror over the sink has been covered with marker graffiti.

You can see a trash can (closed) here.

You can go west to The Proletariat Bar from here.

>open solar panel with multitool
You pry open the solar panel with the pliers in your multitool, ignoring the sound of breaking plastic.
 Opening the solar panel reveals the broadcast chip!

>put broadcast chip in pack
You put the broadcast chip into the backpack.

>open thermos
You open the thermos, revealing a green shirt's antitheft tag, a white shirt's antitheft tag, and a blue jacket's antitheft tag.

>open blue shirt's antitheft tag with knife
Which do you mean, the blue jacket or the blue jacket's antitheft tag?

>open blue jacket's antitheft tag with knife
Taken.

Taken.

You carefully cut open the tag with your knife and peel back the plastic to reveal a blank memory chip.

>put memory in pack
You put the blank memory chip into the backpack.

>drop blue jacket's antitheft tag
Dropped.

>open white shirt's antitheft tag with knife
Taken.

You carefully cut open the tag with your knife and peel back the plastic to reveal a blank memory chip.

>put memory in pack
You put the blank memory chip into the backpack.

>drop white shirt's antitheft tag
Dropped.

>open green shirt's antitheft tag with knife
Taken.

You carefully cut open the tag with your knife and peel back the plastic to reveal a blank memory chip.

>put memory in car key
You put the blank memory chip into the car key.

>drop green shirt's antitheft tag
Dropped.

>put knife in pack
You put the lockblade knife into the backpack.

>w
The Proletariat Bar
The Proletariat is a local bar (not a pub).  It's just far enough above a "dive" to be allowed zoning here, but steadfastedly refuses to cater to upscale tastes.  You like it.  Restrooms are to the east; the bar runs along the north side with a stolid bartender behind it and a jukebox sits against the back wall.  A few hardy drinkers sit here, communing with their spirits.  In a nod to the place's name, a Public Surveillance Notice covered with stickers and graffiti tags has been framed above the bar.

You can see Roberto Velez here.

You can go northwest to Green Commercial Plaza North, southwest to Green Commercial Plaza South, east to Proletariat Restroom, and west to Green Commercial Plaza Center from here.

There is a Public Surveillance Notice here.

>w
Green Commercial Plaza Center
This is the center of the Green Commercial Plaza.  There is a fountain here with a bench facing it.  The plaza continues to the north and south; to the east is a bar called (ironically, you hope) the Proletariat.  To the west is a Bistro Paris cafe.

The Reserve Bank Spacescraper is visible in the distance, rising over the low skyline.

You can also see a trash can (closed) here.

You can go north to Green Commercial Plaza North, northeast, northwest, south to Green Commercial Plaza South, southeast, east to The Proletariat Bar, and west from here.

There is a Public Surveillance Notice here.

>s
Green Commercial Plaza South
The southern end of the Green Commercial Plaza, which continues to the north.  To the east is Accessorize, a fashion store, and to the west is Garb-oh, a trendy clothing shop.  The south end of the mall is closed off by an elaborate landscaping installation of trees and shrubs, presumably to hide a relatively ugly building behind it.

The Reserve Bank Spacescraper is visible in the distance, rising over the low skyline.

A parked police flitter, armored and festooned with lights, looms here.

You can also see a trash can (closed) here.

You can go north to Green Commercial Plaza Center, northeast to The Proletariat Bar, northwest, east, and west through the Garb-oh door (closed) to Garb-oh from here.

There is a Public Surveillance Notice here.

>z
Time passes.

>z
Time passes.

A police officer ambles out of Green Commercial Bistro Paris.  As he approaches the flitter, the flitter key transponder on his belt disables the locklarm.
He then climbs into the flitter and shuts the door.  A few moments later, the aircraft powers up. The turbines spool up and, its beacons flashing, it lifts smoothly into the air, disappearing behind the building tops.
Your hacked car key beeps softly, and its ready light turns green!

>z
Time passes.

>n
Green Commercial Plaza Center
This is the center of the Green Commercial Plaza.  There is a fountain here with a bench facing it.  The plaza continues to the north and south; to the east is a bar called (ironically, you hope) the Proletariat.  To the west is a Bistro Paris cafe.

The Reserve Bank Spacescraper is visible in the distance, rising over the low skyline.

You can also see a trash can (closed) here.

You can go north to Green Commercial Plaza North, northeast, northwest, south to Green Commercial Plaza South, southeast, east to The Proletariat Bar, and west from here.

There is a Public Surveillance Notice here.

>n
Green Commercial Plaza North
Green Commercial One is built around a plaza, and this is its northern end.  No vehicles are permitted within the public areas of Green Commercial One, so the entire area is pedestrian-only.  To the north are the doorways to the Green Commercial Station.  To the east is the NanoMart.  To the west is a storefront bank with an ATM.  The plaza continues to the south.

The Reserve Bank Spacescraper is visible in the distance, rising over the low skyline.

You can also see a trash can (closed) here.

You can go north to Green Commercial Station, south to Green Commercial Plaza Center, southeast to The Proletariat Bar, southwest, east, and west from here.

There is a Public Surveillance Notice here.

>n
Green Commercial Station
Green Commercial One's Transit station usually does most of its business around the rush hours, as Green Residental commuters stop off to take care of errands.  The station is relatively small, but well kept up - the Green Commercial Business Improvement District organization sees to that.  Open doorways lead south to Green Commercial One proper, and a stairway leads down to the doors to the Transit platform.

You can go south to Green Commercial Plaza North and down through the Green Commercial Station door (closed) to Green Commercial Platform from here.

There is a Public Surveillance Notice here.

>d
(first opening the Green Commercial Station door)

Green Commercial Platform
Green Commercial One is one of the oldest stations on the Transit web.  Although it has been refurbished several times, its age still manages to show through the layers of tile and paint.  The platform opens out at the middle to a lobby area which is dominated by a row of automated doors to the south, which lead to stairways up to the main station.  The flow of commuters moves steadily through these doors.  The floor and walls are both extremely scuffed duramex nanotile, and the station name (Green Commercial One) is indicated on a large plaque set into the walls. The platform abuts the Transit web to the north, now empty.

You can see a Transit Map here.

You can go south through the Green Commercial Station door to Green Commercial Station from here.

There is a Public Surveillance Notice here.

A tiny surveillance camera you're sure you didn't see before swivels to follow you.

The automatic door slides closed.

>wait for capsule
A tiny surveillance camera you're sure you didn't see before swivels to follow you.

A public address system reminds you to be alert and "if you see something, say something!"

A commuter walks by.

A light grows in the tunnel.  With a deep thrumming and the whoosh of displaced air, the Transit Capsule slides smoothly into Green Commercial Platform and comes to a stop, hovering in the Web.  The doors slide open and a few commuters enter and exit the capsule.
The Capsule has arrived.  The time is 10:50 pm.
A few commuters get on and off the Transit capsule.

>enter capsule
You move into the Transit Capsule.

Transit Capsule
A fifty-person maglev Transit capsule.  You're standing, holding on to a strap.  Through the windows you can see the Green Commercial Platform.

There is a Public Surveillance Notice here.

A few commuters get on and off the Transit capsule.

>z
Time passes.

A few commuters get on and off the Transit capsule.

The capsule doors slide shut.  The humming noice increases in volume, and the capsule slides out of the station, gathering speed as it goes, and slides into the tunnel.
You hold onto your strap as the Capsule rapidly accelerates.

* * *

>z
Time passes.

>z
Time passes.

With a deep thrumming and the whoosh of displaced air, the Transit Capsule slides smoothly into Green Residential Platform and comes to a stop, hovering in the Web.  The doors slide open and a few commuters enter and exit the capsule.

>z
Time passes.

A few commuters get on and off the Transit capsule.

>exit
Green Residential Platform
Green Residential's platform serves mostly residential commuters.  There is an exit at the center of the platform which leads east through a set of closed automatic doors to a stairway leading up to the main station, just next to a large plaque with the name of the station on it.  The platform abuts the Transit web to the west, where a Transit capsule hovers impatiently.  The capsule doors are open.

You can see a Transit Map here.

You can go east through the Green Residential Station door (closed) to Green Residential Station from here.

There is a Public Surveillance Notice here.

A few commuters get on and off the Transit capsule.

>e
(first opening the Green Residential Station door)
The Eye Scanner laser delicately probes your iris to determine your identity.  The Reserve Bank Security Subroutine determines that you live in Green Residential, and the doors slide smoothly open.

Green Residential Station
This is a utilitarian (read: boring) facility intended mostly to keep the rain out of the Transit System.  A stairway leads down to the Transit platform and an exit leads east to the street.

You can go east to Primrose & Cedar and down through the Green Residential Station door to Green Residential Platform from here.

There is a Public Surveillance Notice here.

The automatic door slides closed.

>e
Primrose & Cedar
This staid neighborhood intersection of Primrose Lane and Cedar Street fronts the local Transit station, Green Residential.  The station entrance is to the west.  Primrose Lane continues to the south, and Cedar Street continues to the east.

The Reserve Bank Spacescraper is visible in the distance, rising over the low skyline.

You can go north to Green Residential Park, south to South Primrose Lane, east, and west to Green Residential Station from here.

There is a Public Surveillance Notice here.

>s
South Primrose Lane
Primrose Lane continues to the north.  To the south is a boarded-up empty house; sumac plants can be seen peeking over the top of the dilapidated fencing.  The fence has a plastic tarp strung behind it which prevents you from seeing much of the house.  To the west is a single-family home with a large warning sign and an enormous dog on the front lawn.  To the east is a three-family residence's front path.

The Reserve Bank Spacescraper is visible in the distance, rising over the low skyline.

You can go north to Primrose & Cedar and east to Front Path from here.

There is a Public Surveillance Notice here.

>cut fence with tag remover
Taken.

You carefully cut through several strands of the fence until you have an opening big enough to slip through and slice a rent in the backing plastic.

>s
Drug Market
Standing just south of the fence, you see an abandoned house on the south side of the lot. The front yard is a mess of trash and litter.  A few people are hanging around the closed front door.  They are looking at you with unfriendly stares.

The Reserve Bank Spacescraper is visible in the distance, rising over the low skyline.

You can go north to South Primrose Lane and south from here.

>n
South Primrose Lane
Primrose Lane continues to the north.  To the south is a boarded-up empty house; sumac plants can be seen peeking over the top of the dilapidated fencing.  The fence has a plastic tarp strung behind it which prevents you from seeing much of the house.  To the west is a single-family home with a large warning sign and an enormous dog on the front lawn.  To the east is a three-family residence's front path.

The Reserve Bank Spacescraper is visible in the distance, rising over the low skyline.

You can go north to Primrose & Cedar, south to Drug Market, and east to Front Path from here.

There is a Public Surveillance Notice here.

>n
Primrose & Cedar
This staid neighborhood intersection of Primrose Lane and Cedar Street fronts the local Transit station, Green Residential.  The station entrance is to the west.  Primrose Lane continues to the south, and Cedar Street continues to the east.

The Reserve Bank Spacescraper is visible in the distance, rising over the low skyline.

You can go north to Green Residential Park, south to South Primrose Lane, east, and west to Green Residential Station from here.

There is a Public Surveillance Notice here.

>w
Green Residential Station
This is a utilitarian (read: boring) facility intended mostly to keep the rain out of the Transit System.  A stairway leads down to the Transit platform and an exit leads east to the street.

You can go east to Primrose & Cedar and down through the Green Residential Station door (closed) to Green Residential Platform from here.

There is a Public Surveillance Notice here.

>d
(first opening the Green Residential Station door)
The Door Scanner scans your iris to determine your identity.  The Transit Security and Accounting Subroutine determines that you have a legitimate account with the Transit system, and the doors slide smoothly open.

Green Residential Platform
Green Residential's platform serves mostly residential commuters.  There is an exit at the center of the platform which leads east through a set of closed automatic doors to a stairway leading up to the main station, just next to a large plaque with the name of the station on it.  The platform abuts the Transit web to the west, now empty.

You can see a Transit Map here.

You can go east through the Green Residential Station door to Green Residential Station from here.

There is a Public Surveillance Notice here.

Warning lights along the platform edge begin to blink rapidly.  A light grows in the tunnel.  With a deep moan and gust of wind, an express Transit Capsule blasts through Green Residential and vanishes into the darkness once more.

The automatic door slides closed.

>wait for capsule
You see a small mouse scurry along the Transit Web and vanish back into the tunnels.

A police officer strolls through the area, giving you a suspicious look before moving on.

A commuter walks by.

A commuter walks by.

A light grows in the tunnel.  With a deep thrumming and the whoosh of displaced air, the Transit Capsule slides smoothly into Green Residential Platform and comes to a stop, hovering in the Web.  The doors slide open and a few commuters enter and exit the capsule.
The Capsule has arrived.  The time is 11:20 pm.
A few commuters get on and off the Transit capsule.

>enter capsule
You move into the Transit Capsule.

Transit Capsule
A fifty-person maglev Transit capsule.  You're standing, holding on to a strap.  Through the windows you can see the Green Residential Platform.

There is a Public Surveillance Notice here.

A few commuters get on and off the Transit capsule.

* * *

>z
Time passes.

>z
Time passes.

With a deep thrumming and the whoosh of displaced air, the Transit Capsule slides smoothly into Green Service Platform and comes to a stop, hovering in the Web.  The doors slide open and a few commuters enter and exit the capsule.

>z
Time passes.

A few commuters get on and off the Transit capsule.

>exit
Green Service Platform
Green Service One's platform is underground.  It serves mostly city workers during the day.  There is an exit at the center of the platform which leads north through a set of closed automatic doors to a stairway leading up to the main station, just next to a large plaque with the name of the station on it.  The platform abuts the Transit web to the south, where a Transit capsule hovers impatiently in the web.  The capsule doors are open.

You can see a Transit Map here.

You can go north through the Green Service Station door (closed) to Green Service Station from here.

There is a Public Surveillance Notice here.

A few commuters get on and off the Transit capsule.

* * *

>n
(first opening the Green Service Station door)

Green Service Station
Green Service is the local government services cluster.  The Transit station seems to reflect this, exhibiting a weary conformity - although you couldn't say exactly how.  A stairway leads down to the platform access doors, and a set of doorways lead north out onto Government Square.

You can go north to Government Square South and down through the Green Service Station door to Green Service Platform from here.

There is a Public Surveillance Notice here.

The automatic door slides closed.

>n
Government Square South
This is the southern half of Government Square.  Several benches and landscape features are scattered throughout the area.  A roadway approaches from the west, loops north around the square and continues to the east.  Groundcars move back and forth along the road, mixed with official vehicles such as police cars, ambulances and the ubiquitous slightly shabby black flitters used by government agencies.  The doors to Green Service Transit station are to the south.  Across the road to the east is Green Hospital's driveway.  The Hospital's main entrance is to the northeast.  The square continues to the north.  To the northwest, across the road on the other side, is the front steps of the local police station.

The Reserve Bank Spacescraper is visible in the distance, rising over the low skyline.

You can go north to Government Square North, northeast to Hospital Entrance, northwest, south to Green Service Station, and east to Hospital Driveway from here.

There is a Public Surveillance Notice here.

>nw
Police Station Steps
These are the busy steps of the local police station.  To the east and southeast is Government Square, while the police station lies at the top to the west. Uniformed police and people in plain clothes are traversing the steps to exit and enter the building.

The Reserve Bank Spacescraper is visible in the distance, rising over the low skyline.

You can go southeast to Government Square South, east to Government Square North, and west from here.

There is a Public Surveillance Notice here.

>w
Front Desk
This is the front desk of the police station. A harried sergeant is manning the desk, and are so busy they don't even have time to give you more than a brief scowl.  To the north is a security gate leading into the police station proper, and to the south is an open area with a sign reading "BOOKING."

You can see Sergeant Ramirez here.

You can go south and east to Police Station Steps from here.

There is a Public Surveillance Notice here.

>ramirez, i want to report a drug market
The sergeant suddenly becomes animated, looking directly at you.  "What?" he barks.  "Drugs?  Where?"  You explain to him that you had seen shifty characters and drugs in the Drug Market.  He picks up the phone and has an animated conversation with someone on the other end, the word "drugs" and "extreme" and "losers" coming up with frequency.  He has lost interest in you.

The door swings open and two officers come in, manhandling a suspect between them.  Ignoring their suspect's complaints, they pause briefly to check in with the desk before moving on into the police station.

>s
Booking
This area is used for processing prisoners…er, excuse me, suspects, and as a waiting lounge.  There is a single hard bench, now empty, and a counter along the south wall with a stern poster on the wall above it.  One area has been kept clear and is a neutral pale blue, presumably to be used as a backdrop for photographing suspects.

You can see an ID camera here.

You can go north to the Front Desk from here.

There is a Public Surveillance Notice here.

>cut chain with tag remover
Looking around to check for watchers, you snip through the ID chain with the tag remover!

>put id camera in pack
You put the ID camera into the backpack.

>put tag remover in pack
You put the tag remover into the backpack.

>n
Front Desk
This is the front desk of the police station. A harried sergeant is manning the desk, and are so busy they don't even have time to give you more than a brief scowl.  To the north is a security gate leading into the police station proper, and to the south is an open area with a sign reading "BOOKING."

You can see Sergeant Ramirez here.

You can go south to Booking and east to Police Station Steps from here.

There is a Public Surveillance Notice here.

>e
Police Station Steps
These are the busy steps of the local police station.  To the east and southeast is Government Square, while the police station lies at the top to the west. Uniformed police and people in plain clothes are traversing the steps to exit and enter the building.

The Reserve Bank Spacescraper is visible in the distance, rising over the low skyline.

You can go southeast to Government Square South, east to Government Square North, and west to the Front Desk from here.

There is a Public Surveillance Notice here.

>e
Government Square North
The north half of Government Square is surrounded on three sides by roadway.  Groundcars trundle back and forth, and the occasional flitter whines down to or screams up from flitter pads near the buildings across it.  The hospital driveway is to the southeast, across the road; the hospital entrance to the east and the police station to the west.  To the north is the steps to the Civil Center, the local government office building.

The Reserve Bank Spacescraper is visible in the distance, rising over the low skyline.

You can go north to Civil Center Steps, south to Government Square South, southeast to Hospital Driveway, east to Hospital Entrance, and west to Police Station Steps from here.

There is a Public Surveillance Notice here.

>s
Government Square South
This is the southern half of Government Square.  Several benches and landscape features are scattered throughout the area.  A roadway approaches from the west, loops north around the square and continues to the east.  Groundcars move back and forth along the road, mixed with official vehicles such as police cars, ambulances and the ubiquitous slightly shabby black flitters used by government agencies.  The doors to Green Service Transit station are to the south.  Across the road to the east is Green Hospital's driveway.  The Hospital's main entrance is to the northeast.  The square continues to the north.  To the northwest, across the road on the other side, is the front steps of the local police station.

The Reserve Bank Spacescraper is visible in the distance, rising over the low skyline.

You can go north to Government Square North, northeast to Hospital Entrance, northwest to Police Station Steps, south to Green Service Station, and east to Hospital Driveway from here.

There is a Public Surveillance Notice here.

>e
Hospital Driveway
The driveway and parking area for the Hospital ER, which lies directly to the east.  To the north is the main entrance to the Hospital building.

The Reserve Bank Spacescraper is visible in the distance, rising over the low skyline.

An ambulance, a bulky flittervan with emergency markings, is parked here.

You can go north to Hospital Entrance, northwest to Government Square North, east through the ER door (closed) to Triage, and west to Government Square South from here.

There is a Public Surveillance Notice here.

A black flittervan cruises slowly by above and vanishes from sight.

>remove receive chip from key
Taken.

>put broadcast chip in key
The ambulance flashes its lights twice as the locklarm unlocks the back.

You put the broadcast chip into the car key.

>put receive in pack
You put the receive chip into the backpack.

There is the sound of sirens in the distance.

>open ambulance
You open the ambulance, revealing a tissue sampler and a medical camera.

>take all
tissue sampler: Taken.
medical camera: Taken.

>put sampler and medical camera in pack
tissue sampler: Done.
medical camera: Done.

>w
Government Square South
This is the southern half of Government Square.  Several benches and landscape features are scattered throughout the area.  A roadway approaches from the west, loops north around the square and continues to the east.  Groundcars move back and forth along the road, mixed with official vehicles such as police cars, ambulances and the ubiquitous slightly shabby black flitters used by government agencies.  The doors to Green Service Transit station are to the south.  Across the road to the east is Green Hospital's driveway.  The Hospital's main entrance is to the northeast.  The square continues to the north.  To the northwest, across the road on the other side, is the front steps of the local police station.

The Reserve Bank Spacescraper is visible in the distance, rising over the low skyline.

You can go north to Government Square North, northeast to Hospital Entrance, northwest to Police Station Steps, south to Green Service Station, and east to Hospital Driveway from here.

There is a Public Surveillance Notice here.

>s
Green Service Station
Green Service is the local government services cluster.  The Transit station seems to reflect this, exhibiting a weary conformity - although you couldn't say exactly how.  A stairway leads down to the platform access doors, and a set of doorways lead north out onto Government Square.

You can go north to Government Square South and down through the Green Service Station door (closed) to Green Service Platform from here.

There is a Public Surveillance Notice here.

>d
(first opening the Green Service Station door)

Green Service Platform
Green Service One's platform is underground.  It serves mostly city workers during the day.  There is an exit at the center of the platform which leads north through a set of closed automatic doors to a stairway leading up to the main station, just next to a large plaque with the name of the station on it.  The platform abuts the Transit web to the south, now empty.

You can see a Transit Map here.

You can go north through the Green Service Station door to Green Service Station from here.

There is a Public Surveillance Notice here.

The automatic door slides closed.

A light grows in the tunnel.  With a deep thrumming and the whoosh of displaced air, the Transit Capsule slides smoothly into Green Service Platform and comes to a stop, hovering in the Web.  The doors slide open and a few commuters enter and exit the capsule.

>wait for capsule
It's already here.

The Capsule has arrived.  The time is 11:50 pm.
A few commuters get on and off the Transit capsule.

>enter capsule
You move into the Transit Capsule.

Transit Capsule
A fifty-person maglev Transit capsule.  You're standing, holding on to a strap.  Through the windows you can see the Green Service Platform.

There is a Public Surveillance Notice here.

A few commuters get on and off the Transit capsule.

* * *

>z
Time passes.

A nearby commuter's handheld begins beeping loudly.  She hurriedly shuts it off.

>z
Time passes.

With a deep thrumming and the whoosh of displaced air, the Transit Capsule slides smoothly into Green Commercial Platform and comes to a stop, hovering in the Web.  The doors slide open and a few commuters enter and exit the capsule.

* * *

>z
Time passes.

A few commuters get on and off the Transit capsule.

>exit
Green Commercial Platform
Green Commercial One is one of the oldest stations on the Transit web.  Although it has been refurbished several times, its age still manages to show through the layers of tile and paint.  The platform opens out at the middle to a lobby area which is dominated by a row of automated doors to the south, which lead to stairways up to the main station.  The flow of commuters moves steadily through these doors.  The floor and walls are both extremely scuffed duramex nanotile, and the station name (Green Commercial One) is indicated on a large plaque set into the walls. The platform abuts the Transit web to the north, where a Transit capsule can be seen hovering.  The capsule doors are open.

You can see a Transit Map here.

You can go south through the Green Commercial Station door (closed) to Green Commercial Station from here.

There is a Public Surveillance Notice here.

A few commuters get on and off the Transit capsule.

* * *

>s
Green Commercial Plaza North
Green Commercial One is built around a plaza, and this is its northern end.  No vehicles are permitted within the public areas of Green Commercial One, so the entire area is pedestrian-only.  To the north are the doorways to the Green Commercial Station.  To the east is the NanoMart.  To the west is a storefront bank with an ATM.  The plaza continues to the south.

The Reserve Bank Spacescraper is visible in the distance, rising over the low skyline.

You can also see a trash can (closed) here.

You can go north to Green Commercial Station, south to Green Commercial Plaza Center, southeast to The Proletariat Bar, southwest, east, and west from here.

There is a Public Surveillance Notice here.

>w
Metro Savings
This is a completely nondescript bank storefront which exists solely to house an ATM.  It's so nondescript, in fact, that it took you some actual effort to determine which bank owns it, probably to ensure that they can charge you access fees no matter what.  To the east is Green Commercial Plaza.

You can see an ATM here.

You can go southeast to Green Commercial Plaza Center and east to Green Commercial Plaza North from here.

There is a Public Surveillance Notice here.

* * *

>put tissue sampler in palm reader
You carefully fit the tissue sampler into the hollow of the palm reader so that it lies over the read area.

>e
Green Commercial Plaza North
Green Commercial One is built around a plaza, and this is its northern end.  No vehicles are permitted within the public areas of Green Commercial One, so the entire area is pedestrian-only.  To the north are the doorways to the Green Commercial Station.  To the east is the NanoMart.  To the west is a storefront bank with an ATM.  The plaza continues to the south.

The Reserve Bank Spacescraper is visible in the distance, rising over the low skyline.

You can also see a trash can (closed) here.

You can go north to Green Commercial Station, south to Green Commercial Plaza Center, southeast to The Proletariat Bar, southwest, east, and west to Metro Savings from here.

There is a Public Surveillance Notice here.

>s
Green Commercial Plaza Center
This is the center of the Green Commercial Plaza.  There is a fountain here with a bench facing it.  The plaza continues to the north and south; to the east is a bar called (ironically, you hope) the Proletariat.  To the west is a Bistro Paris cafe.

The Reserve Bank Spacescraper is visible in the distance, rising over the low skyline.

You can also see a trash can (closed) here.

You can go north to Green Commercial Plaza North, northeast, northwest to Metro Savings, south to Green Commercial Plaza South, southeast, east to The Proletariat Bar, and west from here.

There is a Public Surveillance Notice here.

>s
Green Commercial Plaza South
The southern end of the Green Commercial Plaza, which continues to the north.  To the east is Accessorize, a fashion store, and to the west is Garb-oh, a trendy clothing shop.  The south end of the mall is closed off by an elaborate landscaping installation of trees and shrubs, presumably to hide a relatively ugly building behind it.

The Reserve Bank Spacescraper is visible in the distance, rising over the low skyline.

You can also see a trash can (closed) here.

You can go north to Green Commercial Plaza Center, northeast to The Proletariat Bar, northwest, east, and west through the Garb-oh door (closed) to Garb-oh from here.

There is a Public Surveillance Notice here.

>n
Green Commercial Plaza Center
This is the center of the Green Commercial Plaza.  There is a fountain here with a bench facing it.  The plaza continues to the north and south; to the east is a bar called (ironically, you hope) the Proletariat.  To the west is a Bistro Paris cafe.

The Reserve Bank Spacescraper is visible in the distance, rising over the low skyline.

You can also see a trash can (closed) here.

You can go north to Green Commercial Plaza North, northeast, northwest to Metro Savings, south to Green Commercial Plaza South, southeast, east to The Proletariat Bar, and west from here.

There is a Public Surveillance Notice here.

>e
The Proletariat Bar
The Proletariat is a local bar (not a pub).  It's just far enough above a "dive" to be allowed zoning here, but steadfastedly refuses to cater to upscale tastes.  You like it.  Restrooms are to the east; the bar runs along the north side with a stolid bartender behind it and a jukebox sits against the back wall.  A few hardy drinkers sit here, communing with their spirits.  In a nod to the place's name, a Public Surveillance Notice covered with stickers and graffiti tags has been framed above the bar.

You can see Roberto Velez here.

You can go northwest to Green Commercial Plaza North, southwest to Green Commercial Plaza South, east to Proletariat Restroom, and west to Green Commercial Plaza Center from here.

There is a Public Surveillance Notice here.

>offer blue jacket to roberto
(Roberto Velez)
(first taking the blue jacket)
Roberto stands up and eagerly examines the blue jacket.  "This would be a perfect replacement!" he says enthusiastically, showing you how closely it resembles his torn uniform jacket.  "Would you be willing to part with it? I cannot give you much, but I would happily pay you what I can; it will be less than what those dogs would take from my salary to replace this one!" He pats his pockets, then shakes his head.  "I need to go to the ATM."  With that, he stands up.

Roberto Velez goes northwest.

>nw
Green Commercial Plaza North
Green Commercial One is built around a plaza, and this is its northern end.  No vehicles are permitted within the public areas of Green Commercial One, so the entire area is pedestrian-only.  To the north are the doorways to the Green Commercial Station.  To the east is the NanoMart.  To the west is a storefront bank with an ATM.  The plaza continues to the south.

The Reserve Bank Spacescraper is visible in the distance, rising over the low skyline.

You can also see Roberto Velez and a trash can (closed) here.

You can go north to Green Commercial Station, south to Green Commercial Plaza Center, southeast to The Proletariat Bar, southwest, east, and west to Metro Savings from here.

There is a Public Surveillance Notice here.

Roberto Velez goes west.

>w
Metro Savings
This is a completely nondescript bank storefront which exists solely to house an ATM.  It's so nondescript, in fact, that it took you some actual effort to determine which bank owns it, probably to ensure that they can charge you access fees no matter what.  To the east is Green Commercial Plaza.

You can see Roberto Velez and an ATM here.

You can go southeast to Green Commercial Plaza Center and east to Green Commercial Plaza North from here.

There is a Public Surveillance Notice here.

Roberto approaches the ATM, intent on withdrawing funds to pay you for the blue jacket.
Roberto places his palm on the sampler, hidden inside the ATM.  It flashes briefly.  Nothing else happens.
He shakes his head.  "I am sorry, but the machine is broken."  You reassure him that you don't need paying for the jacket, at which he breaks out into a huge smile, gives you a hug, shakes your hand and quickly changes into the new blue jacket, dropping his torn jacket.  He walks out of the ATM, proudly fingering his new wardrobe.

>take sampler
Taken.

>take torn jacket
Taken.

>wear torn jacket
You put on the torn jacket.

>e
Green Commercial Plaza North
Green Commercial One is built around a plaza, and this is its northern end.  No vehicles are permitted within the public areas of Green Commercial One, so the entire area is pedestrian-only.  To the north are the doorways to the Green Commercial Station.  To the east is the NanoMart.  To the west is a storefront bank with an ATM.  The plaza continues to the south.

The Reserve Bank Spacescraper is visible in the distance, rising over the low skyline.

You can also see a trash can (closed) here.

You can go north to Green Commercial Station, south to Green Commercial Plaza Center, southeast to The Proletariat Bar, southwest, east, and west to Metro Savings from here.

There is a Public Surveillance Notice here.

* * *

>w
Green Commercial Bistro Paris
This is a branch of the popular lunch and coffee shop Bistro Paris.  There are a few tables near the front.  A restroom is to the west.  On the north wall, opposite the counter, is a collection of Paris-themed prints.  In the center is a large holoportrait of the chain's owner, Zuzu, and a sign claiming that the Bistro Paris has restaurants here, in the Reserve Bank Spacescraper, and in London.  A server behind the counter is waiting on several customers.

You can see Officer Prescott and a trash can (closed) here.

You can go northeast to Green Commercial Plaza North, southeast to Green Commercial Plaza South, east to Green Commercial Plaza Center, and west from here.

There is a Public Surveillance Notice here.

>put a memory chip in id camera
(the blank memory chip in the ID camera)
You put the blank memory chip into the film slot.

>photograph Zuzu's eye with id camera
Taken.

The camera emits an artificial-sounding "CLICK" noise.
  The disc icon flashes green, indicating that the image has been stored.

>take photo memory chip
Taken.

>e
Green Commercial Plaza Center
This is the center of the Green Commercial Plaza.  There is a fountain here with a bench facing it.  The plaza continues to the north and south; to the east is a bar called (ironically, you hope) the Proletariat.  To the west is a Bistro Paris cafe.

The Reserve Bank Spacescraper is visible in the distance, rising over the low skyline.

You can also see a trash can (closed) here.

You can go north to Green Commercial Plaza North, northeast, northwest to Metro Savings, south to Green Commercial Plaza South, southeast, east to The Proletariat Bar, and west to Green Commercial Bistro Paris from here.

There is a Public Surveillance Notice here.

>s
Green Commercial Plaza South
The southern end of the Green Commercial Plaza, which continues to the north.  To the east is Accessorize, a fashion store, and to the west is Garb-oh, a trendy clothing shop.  The south end of the mall is closed off by an elaborate landscaping installation of trees and shrubs, presumably to hide a relatively ugly building behind it.

The Reserve Bank Spacescraper is visible in the distance, rising over the low skyline.

A parked police flitter, armored and festooned with lights, looms here.

You can also see a trash can (closed) here.

You can go north to Green Commercial Plaza Center, northeast to The Proletariat Bar, northwest to Green Commercial Bistro Paris, east, and west through the Garb-oh door (closed) to Garb-oh from here.

The police flitter flashes its lights twice as the locklarm disengages.

There is a Public Surveillance Notice here.

>e
Accessorize
This well-lit store purveys all manner of cosmetic aids and fashion accessories.  Everything from wrist bangles to skin creams to custom cosmetic contacts can be purchased here.

You can see a Lens Crafter here.

You can go northwest to Green Commercial Plaza Center and west to Green Commercial Plaza South from here.

There is a Public Surveillance Notice here.

>put photo memory chip in lens crafter
You put the photo memory chip into the data slot.

>turn on lens crafter
The lens crafter machine's screen flashes green.  A message reads "SOURCE DATA ACCEPTED - COSTUME LENS SYNTHESIZED."  The machine hisses slightly, and a sleeve descends around the lens case.  When the sleeve retracts, the lens case is closed.

>take lens case
Taken.

>take photo memory
Taken.

>w
Green Commercial Plaza South
The southern end of the Green Commercial Plaza, which continues to the north.  To the east is Accessorize, a fashion store, and to the west is Garb-oh, a trendy clothing shop.  The south end of the mall is closed off by an elaborate landscaping installation of trees and shrubs, presumably to hide a relatively ugly building behind it.

The Reserve Bank Spacescraper is visible in the distance, rising over the low skyline.

A parked police flitter, armored and festooned with lights, looms here.

You can also see a trash can (closed) here.

You can go north to Green Commercial Plaza Center, northeast to The Proletariat Bar, northwest to Green Commercial Bistro Paris, east to Accessorize, and west through the Garb-oh door (closed) to Garb-oh from here.

The police flitter flashes its lights twice as the locklarm disengages.

There is a Public Surveillance Notice here.

>open flitter
You open the police flitter, revealing a disarmed tear gas grenade and a harness.

>take all
disarmed tear gas grenade: Taken.
harness: (putting the tissue sampler (Roberto) into the backpack to make room)
Taken.

>n
Green Commercial Plaza Center
This is the center of the Green Commercial Plaza.  There is a fountain here with a bench facing it.  The plaza continues to the north and south; to the east is a bar called (ironically, you hope) the Proletariat.  To the west is a Bistro Paris cafe.

The Reserve Bank Spacescraper is visible in the distance, rising over the low skyline.

You can also see a trash can (closed) here.

You can go north to Green Commercial Plaza North, northeast, northwest to Metro Savings, south to Green Commercial Plaza South, southeast to Accessorize, east to The Proletariat Bar, and west to Green Commercial Bistro Paris from here.

There is a Public Surveillance Notice here.

>n
Green Commercial Plaza North
Green Commercial One is built around a plaza, and this is its northern end.  No vehicles are permitted within the public areas of Green Commercial One, so the entire area is pedestrian-only.  To the north are the doorways to the Green Commercial Station.  To the east is the NanoMart.  To the west is a storefront bank with an ATM.  The plaza continues to the south.

The Reserve Bank Spacescraper is visible in the distance, rising over the low skyline.

You can also see a trash can (closed) here.

You can go north to Green Commercial Station, south to Green Commercial Plaza Center, southeast to The Proletariat Bar, southwest to Green Commercial Bistro Paris, east, and west to Metro Savings from here.

There is a Public Surveillance Notice here.

>n
Green Commercial Station
Green Commercial One's Transit station usually does most of its business around the rush hours, as Green Residental commuters stop off to take care of errands.  The station is relatively small, but well kept up - the Green Commercial Business Improvement District organization sees to that.  Open doorways lead south to Green Commercial One proper, and a stairway leads down to the doors to the Transit platform.

You can go south to Green Commercial Plaza North and down through the Green Commercial Station door (closed) to Green Commercial Platform from here.

There is a Public Surveillance Notice here.

* * *

>wait for capsule
A public address system reminds you to be alert and "if you see something, say something!"

A light grows in the tunnel.  With a deep thrumming and the whoosh of displaced air, the Transit Capsule slides smoothly into Green Commercial Platform and comes to a stop, hovering in the Web.  The doors slide open and a few commuters enter and exit the capsule.
The Capsule has arrived.  The time is 12:50 am.
A few commuters get on and off the Transit capsule.

>enter capsule
You move into the Transit Capsule.

Transit Capsule
A fifty-person maglev Transit capsule.  You're standing, holding on to a strap.  Through the windows you can see the Green Commercial Platform.

There is a Public Surveillance Notice here.

A few commuters get on and off the Transit capsule.

* * *

>z
Time passes.

>z
Time passes.

A shabbily-dressed man wanders up to you.  He appears to be about to ask you for something, but then he catches a look at your eyes and instead wanders away again.

>z
Time passes.

With a deep thrumming and the whoosh of displaced air, the Transit Capsule slides smoothly into Green Residential Platform and comes to a stop, hovering in the Web.  The doors slide open and a few commuters enter and exit the capsule.

* * *

>e
Primrose & Cedar
This staid neighborhood intersection of Primrose Lane and Cedar Street fronts the local Transit station, Green Residential.  The station entrance is to the west.  Primrose Lane continues to the south, and Cedar Street continues to the east.

The Reserve Bank Spacescraper is visible in the distance, rising over the low skyline.

You can go north to Green Residential Park, south to South Primrose Lane, east, and west to Green Residential Station from here.

There is a Public Surveillance Notice here.

>s
South Primrose Lane
Primrose Lane continues to the north.  To the south is a boarded-up empty house; sumac plants can be seen peeking over the top of the dilapidated fencing.  The fence has a plastic tarp strung behind it which prevents you from seeing much of the house.  To the west is a single-family home with a large warning sign and an enormous dog on the front lawn.  To the east is a three-family residence's front path.

The Reserve Bank Spacescraper is visible in the distance, rising over the low skyline.

You can go north to Primrose & Cedar, south to Drug Market, and east to Front Path from here.

There is a Public Surveillance Notice here.

You arrive at South Primrose Lane to a scene of chaos.  Police vehicles are pulled up all over the road, cyclone lights flashing.  As you watch, heavily armed SWAT officers file through the hole in the fence towards the Drug Market.   A staticky transmission over the radio of the vehicles near you says quietly "Breaching charges in place."  You can hear a voice on a bullhorn shout "You have thirty seconds to surrender!"

A few seconds later, there is a deep thundering BOOM as the breaching charges detonate, and a confused hubbub as (presumably) the SWAT officers rush into the abandoned house.

>s
A stern-looking patrolman from the cordon intercepts you and firmly tells you to stay back.  You move back to the street.

>z
Time passes.

A black flittervan cruises slowly by above and vanishes from sight.

>z
Time passes.

>z
Time passes.

A black flittervan cruises slowly by above and vanishes from sight.

>z
Time passes.

Eventually, police begin filing back out of the hole in the fence, dragging a few handcuffed suspects with them.  The bright lights across the fence go out, and various SWAT and regular police get back into their assorted vehicles and begin to pull away.  Soon nothing is left except a slight smell of smoke from the breaching charges.

>z
Time passes.

>s
Drug Market
Standing just south of the fence, you see an abandoned house on the south side of the lot. The front yard is a mess of trash and litter.  The area is empty of people; yellow police line tape covers the empty front doorway.

The Reserve Bank Spacescraper is visible in the distance, rising over the low skyline.

You can go north to South Primrose Lane and south from here.

* * *

>s
Drug Den
The empty ruins of a drug market hangout.  The SWAT team's breaching charges have blown the heavy metal main door into the hallway.  The house is thoroughly trashed, and rubble prevents you from moving any further into the building.  Discarded drug paraphernalia and random trash litters the floor.

You can see a metal door (on which is a disarmed breaching charge) here.

You can go north to Drug Market from here.

>put breaching charge in pack
You put the disarmed breaching charge into the backpack.

>n
Drug Market
Standing just south of the fence, you see an abandoned house on the south side of the lot. The front yard is a mess of trash and litter.  The area is empty of people; yellow police line tape covers the empty front doorway.

The Reserve Bank Spacescraper is visible in the distance, rising over the low skyline.

You can go north to South Primrose Lane and south to Drug Den from here.

>n
South Primrose Lane
Primrose Lane continues to the north.  To the south is a boarded-up empty house; sumac plants can be seen peeking over the top of the dilapidated fencing.  The fence has a plastic tarp strung behind it which prevents you from seeing much of the house.  To the west is a single-family home with a large warning sign and an enormous dog on the front lawn.  To the east is a three-family residence's front path.

The Reserve Bank Spacescraper is visible in the distance, rising over the low skyline.

You can go north to Primrose & Cedar, south to Drug Market, and east to Front Path from here.

There is a Public Surveillance Notice here.

* * *

>w
Green Residential Station
This is a utilitarian (read: boring) facility intended mostly to keep the rain out of the Transit System.  A stairway leads down to the Transit platform and an exit leads east to the street.

You can go east to Primrose & Cedar and down through the Green Residential Station door (closed) to Green Residential Platform from here.

There is a Public Surveillance Notice here.

>d
(first opening the Green Residential Station door)
The Door Scanner scans your iris to determine your identity.  The Transit Security and Accounting Subroutine determines that you have a legitimate account with the Transit system, and the doors slide smoothly open.

Green Residential Platform
Green Residential's platform serves mostly residential commuters.  There is an exit at the center of the platform which leads east through a set of closed automatic doors to a stairway leading up to the main station, just next to a large plaque with the name of the station on it.  The platform abuts the Transit web to the west, now empty.

You can see a Transit Map here.

You can go east through the Green Residential Station door to Green Residential Station from here.

There is a Public Surveillance Notice here.

The automatic door slides closed.

>wait for capsule
A light grows in the tunnel.  With a deep thrumming and the whoosh of displaced air, the Transit Capsule slides smoothly into Green Residential Platform and comes to a stop, hovering in the Web.  The doors slide open and a few commuters enter and exit the capsule.
The Capsule has arrived.  The time is 1:20 am.
A few commuters get on and off the Transit capsule.

>enter capsule
You move into the Transit Capsule.

Transit Capsule
A fifty-person maglev Transit capsule.  You're standing, holding on to a strap.  Through the windows you can see the Green Residential Platform.

There is a Public Surveillance Notice here.

A few commuters get on and off the Transit capsule.

* * *

>n
(first opening the Green Service Station door)

Green Service Station
Green Service is the local government services cluster.  The Transit station seems to reflect this, exhibiting a weary conformity - although you couldn't say exactly how.  A stairway leads down to the platform access doors, and a set of doorways lead north out onto Government Square.

You can go north to Government Square South and down through the Green Service Station door to Green Service Platform from here.

There is a Public Surveillance Notice here.

The automatic door slides closed.

>n
Government Square South
This is the southern half of Government Square.  Several benches and landscape features are scattered throughout the area.  A roadway approaches from the west, loops north around the square and continues to the east.  Groundcars move back and forth along the road, mixed with official vehicles such as police cars, ambulances and the ubiquitous slightly shabby black flitters used by government agencies.  The doors to Green Service Transit station are to the south.  Across the road to the east is Green Hospital's driveway.  The Hospital's main entrance is to the northeast.  The square continues to the north.  To the northwest, across the road on the other side, is the front steps of the local police station.

The Reserve Bank Spacescraper is visible in the distance, rising over the low skyline.

You can go north to Government Square North, northeast to Hospital Entrance, northwest to Police Station Steps, south to Green Service Station, and east to Hospital Driveway from here.

There is a Public Surveillance Notice here.

>e
Hospital Driveway
The driveway and parking area for the Hospital ER, which lies directly to the east.  To the north is the main entrance to the Hospital building.

The Reserve Bank Spacescraper is visible in the distance, rising over the low skyline.

An ambulance, a bulky flittervan with emergency markings, is parked here.

You can go north to Hospital Entrance, northwest to Government Square North, east through the ER door (closed) to Triage, and west to Government Square South from here.

The ambulance flashes its lights twice as the locklarm unlocks the back.

There is a Public Surveillance Notice here.

>e
(first opening the ER door)

Triage
This is a triage area for the ER to the east.  To the north is the main Hospital lobby, and west lies the automatic doors out to the driveway.

You can go north to Hospital Lobby, east to the Emergency Room, and west through the ER door to Hospital Driveway from here.

There is a Public Surveillance Notice here.

The automatic door slides closed.

>e
Emergency Room
This is a prep and emergency treatment area for the emergency ward to the east, which is locked.  Triage is to the west, and a door leads north.

You can see a tissue generator here.

You can go north to Hospital Elevators and west to Triage from here.

There is a Public Surveillance Notice here.

>put tissue sampler into read slot
You put the tissue sampler (Roberto) into the read slot.

>turn on tissue generator
(the tissue generator)
Lights flash and the machine hums for a while. With a final hiss, the tissue generator lights an indicator reading "COMPLETE."  You notice the cryopack is now closed and operating.

>take cryopack
(putting the ID camera into the backpack to make room)
Taken.

>w
Triage
This is a triage area for the ER to the east.  To the north is the main Hospital lobby, and west lies the automatic doors out to the driveway.

You can go north to Hospital Lobby, east to the Emergency Room, and west through the ER door (closed) to Hospital Driveway from here.

There is a Public Surveillance Notice here.

>w
(first opening the ER door)

Hospital Driveway
The driveway and parking area for the Hospital ER, which lies directly to the east.  To the north is the main entrance to the Hospital building.

The Reserve Bank Spacescraper is visible in the distance, rising over the low skyline.

An ambulance, a bulky flittervan with emergency markings, is parked here.

You can go north to Hospital Entrance, northwest to Government Square North, east through the ER door to Triage, and west to Government Square South from here.

The ambulance flashes its lights twice as the locklarm unlocks the back.

There is a Public Surveillance Notice here.

The automatic door slides closed.

>w
Government Square South
This is the southern half of Government Square.  Several benches and landscape features are scattered throughout the area.  A roadway approaches from the west, loops north around the square and continues to the east.  Groundcars move back and forth along the road, mixed with official vehicles such as police cars, ambulances and the ubiquitous slightly shabby black flitters used by government agencies.  The doors to Green Service Transit station are to the south.  Across the road to the east is Green Hospital's driveway.  The Hospital's main entrance is to the northeast.  The square continues to the north.  To the northwest, across the road on the other side, is the front steps of the local police station.

The Reserve Bank Spacescraper is visible in the distance, rising over the low skyline.

You can go north to Government Square North, northeast to Hospital Entrance, northwest to Police Station Steps, south to Green Service Station, and east to Hospital Driveway from here.

There is a Public Surveillance Notice here.

* * *

>wait for capsule
You hear a very quiet beep from somewhere you can't identify.

Warning lights along the platform edge begin to blink rapidly.  A light grows in the tunnel.  With a deep moan and gust of wind, an express Transit Capsule blasts through Green Service One and vanishes into the darkness once more.

You see a small mouse scurry along the Transit Web and vanish back into the tunnels.

A light grows in the tunnel.  With a deep thrumming and the whoosh of displaced air, the Transit Capsule slides smoothly into Green Service Platform and comes to a stop, hovering in the Web.  The doors slide open and a few commuters enter and exit the capsule.
The Capsule has arrived.  The time is 1:50 am.
A few commuters get on and off the Transit capsule.

>enter capsule
You move into the Transit Capsule.

Transit Capsule
A fifty-person maglev Transit capsule.  You're standing, holding on to a strap.  Through the windows you can see the Green Service Platform.

There is a Public Surveillance Notice here.

A few commuters get on and off the Transit capsule.

* * *

>z
Time passes.

A few commuters get on and off the Transit capsule.

>exit
Reserve Bank Station
The Reserve Bank Transit Station. The platform opens out at the middle to a lobby area which is dominated by a row of automated doors to the west.  The flow of commuters moves steadily through these doors, with each person turning their head to the right as they approach for the eye scanner to verify their identity before opening the portal long enough for them to slip through.  The floor and walls are both clean duramex nanotile, and the station name (Reserve Bank) is indicated on large plaques set into the walls.  At either end of the platform, closed gates guard against any entry into the slideway tunnels. A platform abuts a Transit web, where a Transit capsule can be seen hovering.  The capsule doors are open.

You can see a Transit Map here.

You can go west through the Reserve Bank Station door (closed) from here.

There is a Public Surveillance Notice here.

A few commuters get on and off the Transit capsule.

>open lens case
You open the lens case.

A few commuters get on and off the Transit capsule.

The capsule doors slide shut.  The humming noice increases in volume, and the capsule slides out of the station, gathering speed as it goes, and slides into the tunnel.

>wear contact lens
(first taking the contact lens)
(putting the lens case into the backpack to make room)
You put on the contact lens.

>put lens case in pack
You put the lens case into the backpack.

>w
(first opening the Reserve Bank Station door)
The Eye Scanner scans the iris printed on the contact lens to determine your identity.  The Reserve Bank Security Subroutine determines that "you" have a legitimate reason to enter the Reserve Bank spacescraper, and the doors slide smoothly open.

Station Corridor
The corridor widens as it terminates at the automatic doors to the Reserve Bank Station, which lies to the east.  We Morlocks trundle to and fro without speaking to each other, in fear of camera and of mike and of might Eloi paycheck-cutting wrath.  Although traffic is overwhelmingly to the west, there are two doors reserved for traffic into the station, indicated by green lightbars overhead, whose access scanners are active.

You can go east through the Reserve Bank Station door to Reserve Bank Station and west from here.

There is a Public Surveillance Notice here.

The automatic door slides closed.

>w
Food Court
The center of the Food Court beneath the Reserve Bank spacescraper is a busy place at all times of the day.  Around the periphery are several food stand franchises, some doing a brisk business.  Hundreds of people are here waiting in line at the food stands, sitting at the dozens of tables in the center, or just passing through from the Reserve Bank Station to the Lift Lobby up a ramp to the west or vice versa.  The floor is made of duramex tiles, nondescript gray matte shedding scuff marks with the determination of the designed servant into nanogrout channels in between.  During the short nighttime lull, the floor will seem to creep slightly as the nanogrout slowly flows the daytime grime along the channels to dispose of it into the walls.

You can see a trash can (closed) here.

You can go north, northeast, northwest, south, southeast, southwest, east to Station Corridor, and west from here.

There is a Public Surveillance Notice here.

>w
Lift Lobby
The Lift Lobby controls underground access to the Reserve Bank spacescraper, beneath the towers of industry and capital made pillars of money and sin.  Hundreds of people rush to and fro through the lobby on their way into or out of the building.  To the north is a large bank of bouncelifts, their liftfields on and glowing faintly blue behind security gates.  Access to the bouncelifts is controlled by Lift Scanners, set above and to the right of each bouncelift entry.  There is no ceiling; several meters up, the room opens out into the street level lobby above.  There is a railing around the perimeter of the floor above; several people are leaning against or over it, watching the flow of commuters below them and around you.  The Atrium, a wide open area extending at least halfway up the spacescraper, is visible above that. There is no way to reach the street lobby from here other than via the bouncelifts. A shallow ramp leads east down to the Food Court.

You can hear the confused murmur of a large crowd coming from the Atrium above.

You can see a Powered Platform (on which is a spool) and the Security Guard here.

You can go east to Food Court and up from here.

There is a Public Surveillance Notice here.

* * *

>enter platform
The security guard looks over, sees your maintenance jacket and gives you a nod.

You get onto the Powered Platform.

On the Powered Platform you can see a spool.

>put spool in pack
You put the spool into the backpack.

>exit
You get off the Powered Platform.

Lift Lobby
The Lift Lobby controls underground access to the Reserve Bank spacescraper, beneath the towers of industry and capital made pillars of money and sin.  Hundreds of people rush to and fro through the lobby on their way into or out of the building.  To the north is a large bank of bouncelifts, their liftfields on and glowing faintly blue behind security gates.  Access to the bouncelifts is controlled by Lift Scanners, set above and to the right of each bouncelift entry.  There is no ceiling; several meters up, the room opens out into the street level lobby above.  There is a railing around the perimeter of the floor above; several people are leaning against or over it, watching the flow of commuters below them and around you.  The Atrium, a wide open area extending at least halfway up the spacescraper, is visible above that. There is no way to reach the street lobby from here other than via the bouncelifts. A shallow ramp leads east down to the Food Court.

You can hear the confused murmur of a large crowd coming from the Atrium above.

You can see a Powered Platform and the Security Guard here.

You can go east to Food Court and up from here.

There is a Public Surveillance Notice here.

>e
Food Court
The center of the Food Court beneath the Reserve Bank spacescraper is a busy place at all times of the day.  Around the periphery are several food stand franchises, some doing a brisk business.  Hundreds of people are here waiting in line at the food stands, sitting at the dozens of tables in the center, or just passing through from the Reserve Bank Station to the Lift Lobby up a ramp to the west or vice versa.  The floor is made of duramex tiles, nondescript gray matte shedding scuff marks with the determination of the designed servant into nanogrout channels in between.  During the short nighttime lull, the floor will seem to creep slightly as the nanogrout slowly flows the daytime grime along the channels to dispose of it into the walls.

You can see a trash can (closed) here.

You can go north, northeast, northwest, south, southeast, southwest, east to Station Corridor, and west to Lift Lobby from here.

There is a Public Surveillance Notice here.

>nw
Maintenance Area
This corner of the food court is drab and uninhabited.  A closed door marked "MAINTENANCE" lurks to the west, and another marked "RESTROOM" to the north.  The floor and walls are scuffed around the door, no doubt from cleaning implements banging against them on their daily travels.

You can go north, south, southeast to Food Court, east, and west through the Maintenance Door (closed) from here.

>open cryopack
A small cloud of chill and condensation escapes from the cryopack into the surrounding air.  The green LED on it goes out; a red one lights up.

You open the cryopack, revealing a skin sample.

>wear sample
Fortunately it's sticky enough to adhere to your palm.

(first taking the skin sample)
You put on the skin sample.

>w
(first opening the Maintenance Door)
You press your doctored palm against the scanner.  The lock clicks open.

Utility Closet
The maintenance closet is dimly lit and, ironically, not terribly clean.  There are various cleaning implements and supplies stored on shelves around the walls, a fire equipment wall rack, and a large metal solvents cabinet taking up one wall.  A flourescent light panel flickers wanly in the ceiling. Two doors lead out of the closet, one east and one west.

On the wall rack are a gas mask and a Fire Axe.

A scuffed disposable camera with a building property sticker on it is here.  Written on it in marker are the words "DOCUMENT ALL MAINTENANCE ITEMS."

You can go east through the Maintenance Door to Maintenance Area and west from here.

The automatic door slides closed.

>put maintenance camera and mask in pack
maintenance camera: Done.
gas mask: Done.

>combine harness and spool
(first taking the spool)
You fashion the harness and the spool into a descender!

>put descender in pack
You put the descender into the backpack.

>drop cryopack
Dropped.

>put photo chip in chipslot
The Download light flashes red intermittently for a few seconds before returning to a regular blinking green.

>put attack chip in pack
You put the attack memory chip into the backpack.

>put transponder chip in chipslot
The Download light flashes red intermittently for a few seconds before returning to a regular blinking green.

>take attack chip from chipslot
Taken.

>put attack chip in pack
You put the attack memory chip into the backpack.

>put blank memory chip in chipslot
The Download light flashes red intermittently for a few seconds before returning to a regular blinking green.

>take attack chip from chipslot
Taken.

* * *

>put attack chip in pack
You put the attack memory chip into the backpack.

>take broadcast chip from key
Taken.

>put broadcast chip in pack
You put the broadcast chip into the backpack.

>take mask and multitool
gas mask: Taken.
multitool: Taken.

>e
(first opening the Maintenance Door)

Maintenance Area
This corner of the food court is drab and uninhabited.  A closed door marked "MAINTENANCE" lurks to the west, and another marked "RESTROOM" to the north.  The floor and walls are scuffed around the door, no doubt from cleaning implements banging against them on their daily travels.

You can go north, south, southeast to Food Court, east, and west through the Maintenance Door to the Utility Closet from here.

The automatic door slides closed.

>se
Food Court
The center of the Food Court beneath the Reserve Bank spacescraper is a busy place at all times of the day.  Around the periphery are several food stand franchises, some doing a brisk business.  Hundreds of people are here waiting in line at the food stands, sitting at the dozens of tables in the center, or just passing through from the Reserve Bank Station to the Lift Lobby up a ramp to the west or vice versa.  The floor is made of duramex tiles, nondescript gray matte shedding scuff marks with the determination of the designed servant into nanogrout channels in between.  During the short nighttime lull, the floor will seem to creep slightly as the nanogrout slowly flows the daytime grime along the channels to dispose of it into the walls.

You can see a trash can (closed) here.

You can go north, northeast, northwest to Maintenance Area, south, southeast, southwest, east to Station Corridor, and west to Lift Lobby from here.

There is a Public Surveillance Notice here.

>arm grenade
You pull the pin on the tear gas grenade and drop it as it begins to hiss!

>z
Time passes.

With a bang and an enormous hiss, the gas grenade goes off and fills the area with a cloud of opaque smoke and tear gas!

>wear mask
You put on the gas mask.

Billowing clouds of tear gas and smoke make it difficult to see.

>open solar panel with tool
You pry open the solar panel with the pliers in your multitool, ignoring the sound of breaking plastic.
 Opening the solar panel reveals the broadcast chip!

Billowing clouds of tear gas and smoke make it difficult to see.

>take broadcast chip
Taken.

>nw
Maintenance Area
This corner of the food court is drab and uninhabited.  A closed door marked "MAINTENANCE" lurks to the west, and another marked "RESTROOM" to the north.  The floor and walls are scuffed around the door, no doubt from cleaning implements banging against them on their daily travels.

You can go north, south, southeast to Food Court, east, and west through the Maintenance Door (closed) to the Utility Closet from here.

>w
(first opening the Maintenance Door)
You press your doctored palm against the scanner.  The lock clicks open.

Utility Closet
The maintenance closet is dimly lit and, ironically, not terribly clean.  There are various cleaning implements and supplies stored on shelves around the walls, a fire equipment wall rack, and a large metal solvents cabinet taking up one wall.  A flourescent light panel flickers wanly in the ceiling. Two doors lead out of the closet, one east and one west.

On the wall rack is a Fire Axe.

You can also see a cryopack (empty) here.

You can go east through the Maintenance Door to Maintenance Area and west from here.

The automatic door slides closed.

>drop mask
(first taking the gas mask off)
Dropped.

>put tool in pack
You put the multitool into the backpack.

>take solder and iron
solder: Taken.
soldering iron: Taken.

>combine broadcast and attack
(first taking the attack memory chip)
You switch the soldering iron on.

You fashion the attack memory chip and the broadcast chip into a Klein Blaster!

>g
(first taking the attack memory chip)
(first taking the broadcast chip)
You fashion the attack memory chip and the broadcast chip into a Klein Blaster!

>g
(first taking the attack memory chip)
(first taking the broadcast chip)
(putting the solder into the backpack to make room)
You don't have the proper tools.

>put klein blaster in pack
You put the Klein Blaster into the backpack.

>put klein blaster in pack
You put the Klein Blaster into the backpack.

>take solder
Taken.

>combine broadcast and memory
You fashion the attack memory chip and the broadcast chip into a Klein Blaster!

>turn off iron
You switch the soldering iron off.

>drop iron and solder
soldering iron: Dropped.
solder: Dropped.

>open lost camera with tool
Taken.

You pry open the lost camera with the pliers in your multitool, ignoring the sound of breaking plastic.

>open maintenance camera with tool
Taken.

You pry open the maintenance camera with the pliers in your multitool, ignoring the sound of breaking plastic.

>open medical camera with tool
Taken.

You pry open the medical camera with the pliers in your multitool, ignoring the sound of breaking plastic.

>combine klein blaster and medical camera
You fashion the Klein Blaster and the medical camera into a disarmed ID bomb!

>combine klein blaster and lost camera
(first taking the Klein Blaster)
You fashion the Klein Blaster and the lost camera into a disarmed ID bomb!

>combine klein blaster and maintenance camera
(first taking the Klein Blaster)
You fashion the Klein Blaster and the maintenance camera into a disarmed ID bomb!

>wear descender
(first taking the descender)
You put on the descender.

>take axe
This axe is large enough to run afoul of local weapons laws.  It would be a bad idea to let it be seen where the police are watching.

* * *

>e
You angle yourself towards the door.  The liftfield gently moves you to the edge of the tube, and you swing yourself out of the lift via the safety handle.

Bouncelift Vestibule
The service bouncelift opens onto a small vestibule, not much larger than the size of a closet.  A sign painted on the wall reads "LEVEL 35 - MEZZANINE". There is a door with a palm lock to the east.

You can go east through Vestibule Door (closed) and west to Top of Service Bouncelift from here.

>l door
(Vestibule Door)
A scuffed but sturdy security door. There is a palm lock on this side to prevent unauthorized access to the floor beyond.  It looks like the lock is a retrofit, as it is attached to the door rather than an integral part. A sign reads "PUBLIC AREA BEYOND THIS DOOR."

>chop lock with axe
You heft the axe and set to.  The lock gives way before your furious assault!

>drop axe
Dropped.

* * *

>e
Seating Area
The corridor ends in a small open seating area.  There is a door leading north, presumably to the rest of the office space.  It is closed and locked.  An observation window looks out east onto a ledge over the spacescraper's hollow core.

You can go west to Office Corridor from here.

There is a Public Surveillance Notice here.

>x window
A wall-sized armorcrys window which looks out over a ledge jutting into the airspace of the spacescraper's atrium.  The ledge, one of many spotted around the interior of the atrium, holds some flowers and a single tree, all in plascrete planters.

>put breaching charge on window
(first taking the disarmed breaching charge)

You put the disarmed breaching charge on the observation window.

>arm charge
You pull the arming tab out and drop it, arming the Breaching Charge.
As soon as the charge detonates, the police will be looking at the surveillance video from this location; they'll ID you within a few minutes!

>w
Office Corridor
You are in the middle of a nondescript office corridor.  To the west is a security door to the service bouncelift.  To the north is a door reading "RESTROOM".  The corridor continues to the east.

You can go north, east to Seating Area, and west through Vestibule Door to Bouncelift Vestibule from here.

There is a Public Surveillance Notice here.

>z
Time passes.

>z
Time passes.

There is a loud BOOM from nearby! The floor shakes.

>e
Seating Area
The corridor ends in a small open seating area.  There is a door leading north, presumably to the rest of the office space.  It is closed and locked.  The wreckage of an observation window leads east out to a ledge.

There are the unmistakable signs of a blast.  Scarring and burn marks are everywhere, and a choking smell of explosives residues hangs in the air.

You can go east and west to Office Corridor from here.

There is a Public Surveillance Notice here.

>e
You step gingerly through the jagged hole in the observation window onto the ledge.

Atrium Ledge
This ledge, along with the others at the Mezzanine level, looks out over the huge hollow core of the Reserve Bank spacescraper's lower third.  The central column containing the main bouncelifts is visible perhaps fifty meters away.   Above, the roof of the atrium is hazily visible through the glare from its light fixtures some thirty floors up.  Thirty floors below, the main lobby can be made out.  To one side of the bouncelift column, the sublevel Lift Lobby can be seen one level below.  A very low glass wall surrounds the ledge for safety, but it's clear that this space isn't meant for the public.  There are a few holes in the plascrete floor where plants once rested; one large planter in the center holds a scarred but defiantly unbent tree.

>attach cable to tree
You pass the cable around the tree and snap the carabiner on the end around it, firmly attaching the cable to the tree.

You're pretty sure the police are looking for you now for setting off that explosive.

>d
You carefully ease yourself over the edge, and before you can think better of it you let go!  The descender slowly pays out cable with a steady whir, and you find yourself dropping through empty space!

The Atrium (Midair)
You are hanging in empty space some ways down from the ledge, the cable attached to your harness holding you face-down.  Below you you can see the crowds of people at the convention gathered on the Atrium floor.

* * *

>arm id bomb
You arm the bomb and toss it. The bomb spins down out of sight towards a window wall.  A few seconds later you make out a slight twinkling as the flash unit fires.  A low noise, of a crowd confused, slowly rises in volume!

The descender whirs steadily as it lowers you.

The Atrium (Midair)
You are hanging in empty space some ways down from the ledge, the cable attached to your harness holding you face-down.  Below you you can see the crowds of people at the convention gathered on the Atrium floor.

>arm id bomb
Arming another bomb, you toss it away into the atrium where crowds are gathering at the windows!  The bomb flashes just in front of a large crowd gathered before a window wall, and they begin to mill about in panic and confusion!  The noise inside the atrium rises!

The descender whirs steadily as it lowers you.

The Atrium (Midair)
You are perhaps halfway down the atrium now.  You can make out individual people in the crowd of Homeland Security conventioneers below you.  People are coming to the windows all around the atrium now as word of your descent spreads.

>arm id bomb
You arm your third ID bomb and drop it directly down into the crowds in the Main Lobby, where you can see police and Homeland Security forces pointing up at you as they maneuver into place.  There is a definite flinching in the crowd as the bomb goes off nearly at floor level, and the law enforcement personnel are instantly swamped by the confused masses of convention attendees as everyone on the Lobby floor is cut off from communicating directly with their electronics!

The descender whirs steadily as it lowers you.

The Atrium (Midair)
You are nearly to the bottom.  The crowd below you has seen you, and a few people are pointing up.

>z
Time passes.

The descender whirs steadily as it lowers you.

Main Lobby
This is the floor level of the main lobby, at the bottom of the tower atrium.

You can go up to the The Atrium (Midair) and down to Lift Lobby from here.

You reach the floor of the Main Lobby.  The confusion is immense, as thousands of people realize that their MitKlein bottles no longer function.  The various law enforcement personnel throughout the crowd are distracted and paralyzed by the fact that their equipment will no longer recognize them.  In the confusion, your landing goes nearly unnoticed.  You slip out of the descender and it whisks back upwards out of sight.

Soon, new police enter the lobby and begin organizing an evacuation while others continue their futile search for the unknown attacker.  A policeman gestures at you and a group of people near you to follow him and turns to head downstairs towards the Transit station.  You watch as everyone turns to follow the policeman, but you know that the police can't save them.

The police can't save you.  I can.  I will.  I'm coming for you.  I'm coming for all of you.

Meek and obedient, you follow the leader down well-trodden corridors, down into the Valley of Steel!

    *** You are free! ***

Would you like to RESTART, RESTORE a saved game, QUIT, or UNDO the last command?

* * *

>wear watch
You put on the watch.

>n
You can't go that way.

>n
You can't go that way.

>n
You can't go that way.

There is a quiet tone from your phone and you feel a short vibration, indicating that an SMS message has arrived.

>rules
Rules tracing now switched on. Type "rules off" to switch it off again, or "rules all" to include even rules which do not apply.

>n
[Rule "standard set going variables rule" applies.]
[Rule "can't travel in what's not a vehicle rule" applies.]
[Rule "can't go through undescribed doors rule" applies.]
[Rule "can't go through closed doors rule" applies.]
[Rule "determine map connection rule" applies.]
[Rule "can't go that way rule" applies.]
You can't go that way.

[Rule "Every Turn during Transit Stop" applies.]
[Rule "scene description text rule" applies.]

>rules off
Rules tracing now switched off. Type "rules" to switch it on again.

>i
You are carrying:
  a backpack (being worn, and open but empty)
  a multitool
  a watch (being worn)
  a phone

* * *

>wear watch
You put on the watch.

>x watch
A cheap digital, your watch reads 7:31 pm.

>look
Green Residential Park
Primrose Street ends here in a small circular cul-de-sac.  You're in a small green park to the north of this, bounded on its three other sides by high fences.  A few trees rise over well-manicured grass.  There is a curfew sign at the park's entrance.

The Reserve Bank Spacescraper is visible in the distance, rising over the low skyline.

You can go south from here.

There is a Public Surveillance Notice here.

>i
You are carrying:
  a backpack (being worn, and open but empty)
  a multitool
  a watch (being worn)
  a phone

>s
Primrose & Cedar
This staid neighborhood intersection of Primrose Lane and Cedar Street fronts the local Transit station, Green Residential.  The station entrance is to the west.  Primrose Lane continues to the south, and Cedar Street continues to the east.

The Reserve Bank Spacescraper is visible in the distance, rising over the low skyline.

You can go north to Green Residential Park, south, east, and west from here.

There is a Public Surveillance Notice here.

* * *

>w
As you approach the lawn of the house, the large dog raises its head to look at you and growls, softly but very communicatively.  You decide discretion is the better part of valor and retreat.

There is a quiet tone from your phone and you feel a short vibration, indicating that an SMS message has arrived.

* * *

>l street
Just what you'd expect.

>l cul-de-sac
Perfectly boring.

>hit sign
Violence isn't the answer to this one.

>s
Primrose & Cedar
This staid neighborhood intersection of Primrose Lane and Cedar Street fronts the local Transit station, Green Residential.  The station entrance is to the west.  Primrose Lane continues to the south, and Cedar Street continues to the east.

The Reserve Bank Spacescraper is visible in the distance, rising over the low skyline.

You can go north to Green Residential Park, south, east, and west from here.

There is a Public Surveillance Notice here.

* * *

>kick dog
Uh…you really, REALLY don't want to try that.

There is a quiet tone from your phone and you feel a short vibration, indicating that an SMS message has arrived.

>read message
Message 1 reads: REPORT RECEIVED.  MISSION SUCCESSFUL.  ATTACK PROGRAM CREATED USING INFORMATION IN REPORT. <more>.

>g
Message 2 reads: DANGER DANGER DANGER:  OPERATIVE COMPROMISED DURING OPERATION.  YOUR MITKLEIN CODE READ BY HOMELAND SECURITY.  YOUR ID RECORDS DELETED BUT MITKLEIN CODE ALONE ENOUGH TO ID YOU AS TARGET.<more>.

* * *

>g
Message 10 reads: GOOD LUCK. MESSAGE ENDS..

>g
Message 1 reads: REPORT RECEIVED.  MISSION SUCCESSFUL.  ATTACK PROGRAM CREATED USING INFORMATION IN REPORT. <more>.

>e
Front Path
This front path is paved with cracked flagstones.  Primrose Lane is to the west, a three-family building is to the east, and the building's side yard is to the northeast.

The Reserve Bank Spacescraper is visible in the distance, rising over the low skyline.

You can go northeast, east through the House door (closed), and west to South Primrose Lane from here.

There is a Public Surveillance Notice here.

>k path
That's not a verb I recognize.

>x path
You can't see any such thing.

>x flagstones
Weathered stones, which appear to be naturally smooth rather than having been shaped.

>move stones
Those are fixed in place.

>take stones
They're hardly portable.

>look under stones
Those are fixed in place.

>actions
Actions listing on.

>look under stones
[looking under the flagstones]
You find nothing of interest.

[looking under the flagstones - succeeded]