Welcome to the future.  Every citizen has been scanned, chipped, folded, spindled and mutilated - and it's enough to make you scream.

Valley of Steel
A tale of the surveillance society by The Custodian of http://everything2.com
Release 1 / Serial number 130319 / Inform 7 build 6G60 (I6/v6.32 lib 6/12N) SD

Bedroom
Your bedroom is rather boring.  It contains your bed - currently unmade - and the usual assortment of bedroom furnishings including a bedside table, next to the bed.

On the bedside table are a watch and a phone.

You can go north and west from here.

>wear watch
(first taking the watch)
You put on the watch.

>put phone in pack
You put the phone into the backpack.

>w
Hall
The central hallway of your modest home.  It's relatively clean and neat, as there is no furniture in it.

You can go north, east to the Bedroom and west from here.

* * *

>take knife
This knife is large enough to run afoul of local weapons laws.  It would be a bad idea to let it be seen where the police are watching.

>open key
That's not something you can open.

>cut key
What do you want to cut it with?

>cut key with knife
You carefully cut open the car keys with your knife and peel back the rubber to reveal a broadcast chip and a memory chip.

>take broadcast and memory
broadcast chip: Taken.
memory chip: Taken.

>put key in pack
You put the car key into the backpack.

>put knife in pack
You put the lockblade knife into the backpack.

>put memory in chipslot
The Download light flashes red intermittently for a few seconds before returning to a regular blinking green.

* * *

>take memory
Taken.

>take solder and iron
solder: Taken.
soldering iron: Taken.

>combine broadcast and memory
You switch the soldering iron on.

You fashion the broadcast chip and the programmed memory chip into a Klein Blaster!

That isn't available.

>undo
Home Office
[Previous turn undone.]

>rules
Rules tracing now switched on. Type "rules off" to switch it off again, or "rules all" to include even rules which do not apply.

>undo
Home Office
[Previous turn undone.]

>take solder and iron
solder: You already have that.
soldering iron: You already have that.

>rules
Rules tracing now switched on. Type "rules off" to switch it off again, or "rules all" to include even rules which do not apply.

>combine broadcast and memory
[Rule "First Check and-combining" applies.]
[Rule "Carry out and-combining" applies.]
[Rule "Setting action variables for combining something with something" applies.]
[Rule "Check combining it with" applies.]
[Rule "Check switching on the soldering iron" applies.]
[Rule "can't switch on unless switchable rule" applies.]
[Rule "can't switch on what's already on rule" applies.]
[Rule "standard switching on rule" applies.]
[Rule "standard report switching on rule" applies.]
You switch the soldering iron on.

[Rule "Carry out combining it with" applies.]
[Rule "Report combining it with" applies.]
You fashion the broadcast chip and the programmed memory chip into a Klein Blaster!

That isn't available.

[Rule "Every Turn during Transit Enroute" applies.]

* * *

Welcome to the future.  Every citizen has been scanned, chipped, folded, spindled and mutilated - and it's enough to make you scream.

Valley of Steel
A tale of the surveillance society by The Custodian of http://everything2.com
Release 1 / Serial number 130319 / Inform 7 build 6G60 (I6/v6.32 lib 6/12N) SD

Bedroom
Your bedroom is rather boring.  It contains your bed - currently unmade - and the usual assortment of bedroom furnishings including a bedside table, next to the bed.

On the bedside table are a watch and a phone.

You can go north and west from here.

>purloin broadcast and memory and laptop
[Purloined.]
[Purloined.]
[Purloined.]

>put memory in chipslot
The Download light flashes red intermittently for a few seconds before returning to a regular blinking green.

* * *

>put laptop in pack
You put the laptop into the backpack.

>purloin solder and iron
[Purloined.]
[Purloined.]

>attach broadcast and memory
You switch the soldering iron on.

You fashion the programmed memory chip and the broadcast chip into a Klein Blaster!

* * *

Welcome to the future.  Every citizen has been scanned, chipped, folded, spindled and mutilated - and it's enough to make you scream.

Valley of Steel
A tale of the surveillance society by The Custodian of http://everything2.com
Release 1 / Serial number 130319 / Inform 7 build 6G60 (I6/v6.32 lib 6/12N) SD

Bedroom
Your bedroom is rather boring.  It contains your bed - currently unmade - and the usual assortment of bedroom furnishings including a bedside table, next to the bed.

On the bedside table are a watch and a phone.

You can go north and west from here.

>gonear jukebox
The Proletariat Bar
The Proletariat is a local bar (not a pub).  It's just far enough above a "dive" to be allowed zoning here, but steadfastedly refuses to cater to upscale tastes.  You like it.  Restrooms are to the east; the bar runs along the north side, a jukebox sits against the back wall, and the rest of the space is filled with bar tables.  A few hardy drinkers sit here, communing with their spirits.  In a nod to the place's name, a Public Surveillance Notice covered with stickers and graffiti tags has been framed above the bar.

You can go northwest, southwest, east and west from here.

>e
Proletariat restroom
The one-holer restroom at the Proletariat is cleaner than you might think, although that may be due to the fact that it is midweek.  A scratched mirror over the sink has been covered with marker graffiti.

You can see a trash can (closed) here.

You can go west to The Proletariat Bar from here.

>purloin gas mask
[Purloined.]

>put gas mask in pack
You put the gas mask into the backpack.

>purloin tear gas grenade and tool
[Purloined.]
[Purloined.]

>w
The Proletariat Bar
The Proletariat is a local bar (not a pub).  It's just far enough above a "dive" to be allowed zoning here, but steadfastedly refuses to cater to upscale tastes.  You like it.  Restrooms are to the east; the bar runs along the north side, a jukebox sits against the back wall, and the rest of the space is filled with bar tables.  A few hardy drinkers sit here, communing with their spirits.  In a nod to the place's name, a Public Surveillance Notice covered with stickers and graffiti tags has been framed above the bar.

You can go northwest, southwest, east to the Proletariat restroom and west from here.

>w
Green Commercial Plaza Center
This is the center of the Green Commercial Plaza.  There is a fountain here with a bench facing it.  The plaza continues to the north and south; to the east is a bar called (ironically, you hope) the Proletariat.  To the west is a Bistro Paris cafe.

You can see a trash can (closed) here.

You can go north, northeast, northwest, south, southeast, east to The Proletariat Bar and west from here.

There is a Public Surveillance Notice here.

>arm tear gas grenade
You pull the pin on the Tear gas grenade and drop it as it begins to hiss!

>z
Time passes.

With a bang and an enormous hiss, the gas grenade goes off and fills the area with a cloud of opaque smoke and tear gas!

>put on mask
(first taking the gas mask)
You put on the gas mask.

Billowing clouds of tear gas and smoke make it difficult to see.

>open solar panel with tool
You pry open the solar panel with the pliers in your multitool, ignoring the cracking sounds.

Billowing clouds of tear gas and smoke make it difficult to see.

>take broadcast
Taken.

>e
The Proletariat Bar
The Proletariat is a local bar (not a pub).  It's just far enough above a "dive" to be allowed zoning here, but steadfastedly refuses to cater to upscale tastes.  You like it.  Restrooms are to the east; the bar runs along the north side, a jukebox sits against the back wall, and the rest of the space is filled with bar tables.  A few hardy drinkers sit here, communing with their spirits.  In a nod to the place's name, a Public Surveillance Notice covered with stickers and graffiti tags has been framed above the bar.

You can go northwest, southwest, east to the Proletariat restroom and west to Green Commercial Plaza Center from here.

>put mask in pack
(first taking it off)
You put the gas mask into the backpack.

* * *

>l
The Proletariat Bar
The Proletariat is a local bar (not a pub).  It's just far enough above a "dive" to be allowed zoning here, but steadfastedly refuses to cater to upscale tastes.  You like it.  Restrooms are to the east; the bar runs along the north side, a jukebox sits against the back wall, and the rest of the space is filled with bar tables.  A few hardy drinkers sit here, communing with their spirits.  In a nod to the place's name, a Public Surveillance Notice covered with stickers and graffiti tags has been framed above the bar.

You can go northwest, southwest, east and west from here.

There is a Public Surveillance Notice here.

>read notice
A mounted sign which reads: PUBLIC SURVEILLANCE AREA.  ALL ACTIVITY MONITORED FOR HOMELAND SECURITY.

>l jukebox
A retro-themed music player with imitation vinyl records visible within its transparent cabinet, this jukebox actually operates via a network connection.   It doesn't require money, but then again the users can't really select music on it, either, so fair is fair.

The Jukebox is currently switched off.

>switch jukebox
You switch the Jukebox on.

>l
The Proletariat Bar
The Proletariat is a local bar (not a pub).  It's just far enough above a "dive" to be allowed zoning here, but steadfastedly refuses to cater to upscale tastes.  You like it.  Restrooms are to the east; the bar runs along the north side, a jukebox sits against the back wall, and the rest of the space is filled with bar tables.  A few hardy drinkers sit here, communing with their spirits.  In a nod to the place's name, a Public Surveillance Notice covered with stickers and graffiti tags has been framed above the bar.

A low tune can barely be made out over the ambient noise.

You can go northwest, southwest, east and west from here.

There is a Public Surveillance Notice here.

>z
Time passes.

>listen to jukebox
You hear nothing unexpected.

>l jukebox
A retro-themed music player with imitation vinyl records visible within its transparent cabinet, this jukebox actually operates via a network connection.   It doesn't require money, but then again the users can't really select music on it, either, so fair is fair. It is playing a subdued post-punk Musak adaptation of some anti-government tune.

The Jukebox is currently switched on.

>e
Proletariat restroom
The one-holer restroom at the Proletariat is cleaner than you might think, although that may be due to the fact that it is midweek.  A scratched mirror over the sink has been covered with marker graffiti.

You can see a trash can (closed) here.

You can go west to The Proletariat Bar from here.

>purloin gas mask and tool and tear gas grenade
[Purloined.]
[Purloined.]
[Purloined.]

>w
The Proletariat Bar
The Proletariat is a local bar (not a pub).  It's just far enough above a "dive" to be allowed zoning here, but steadfastedly refuses to cater to upscale tastes.  You like it.  Restrooms are to the east; the bar runs along the north side, a jukebox sits against the back wall, and the rest of the space is filled with bar tables.  A few hardy drinkers sit here, communing with their spirits.  In a nod to the place's name, a Public Surveillance Notice covered with stickers and graffiti tags has been framed above the bar.

You barely recognize the Muzak as something that was once punk.

You can go northwest, southwest, east to the Proletariat restroom and west from here.

There is a Public Surveillance Notice here.

>w
Green Commercial Plaza Center
This is the center of the Green Commercial Plaza.  There is a fountain here with a bench facing it.  The plaza continues to the north and south; to the east is a bar called (ironically, you hope) the Proletariat.  To the west is a Bistro Paris cafe.

You can see a trash can (closed) here.

You can go north, northeast, northwest, south, southeast, east to The Proletariat Bar and west from here.

There is a Public Surveillance Notice here.

>arm grenade
You pull the pin on the Tear gas grenade and drop it as it begins to hiss!

>z
Time passes.

With a bang and an enormous hiss, the gas grenade goes off and fills the area with a cloud of opaque smoke and tear gas!

>put on mask
You put on the gas mask.

Billowing clouds of tear gas and smoke make it difficult to see.

>open solar panel with tool
You pry open the solar panel with the pliers in your multitool, ignoring the cracking sounds.

Billowing clouds of tear gas and smoke make it difficult to see.

* * *

>take broadcast
Taken.

>e
The Proletariat Bar
The Proletariat is a local bar (not a pub).  It's just far enough above a "dive" to be allowed zoning here, but steadfastedly refuses to cater to upscale tastes.  You like it.  Restrooms are to the east; the bar runs along the north side, a jukebox sits against the back wall, and the rest of the space is filled with bar tables.  A few hardy drinkers sit here, communing with their spirits.  In a nod to the place's name, a Public Surveillance Notice covered with stickers and graffiti tags has been framed above the bar.

You barely recognize the Muzak as something that was once punk.

You can go northwest, southwest, east to the Proletariat restroom and west to Green Commercial Plaza Center from here.

There is a Public Surveillance Notice here.

Policemen rush into the area and grab you.  Wearing gas masks in public is against Homeland Security regulations!

    *** You have been arrested! ***

Would you like to RESTART, RESTORE a saved game, QUIT or UNDO the last command?

* * *

Welcome to the future.  Every citizen has been scanned, chipped, folded, spindled and mutilated - and it's enough to make you scream.

Valley of Steel
A tale of the surveillance society by The Custodian of http://everything2.com
Release 1 / Serial number 130319 / Inform 7 build 6G60 (I6/v6.32 lib 6/12N) SD

Bedroom
Your bedroom is rather boring.  It contains your bed - currently unmade - and the usual assortment of bedroom furnishings including a bedside table, next to the bed.

On the bedside table are a watch and a phone.

You can go north and west from here.

>purloin spool and harness
[Purloined.]
[Purloined.]

>combine harness and spool
flag is false!

You fashion the harness and the spool into a descender!

>undo
Bedroom
[Previous turn undone.]

>rules
Rules tracing now switched on. Type "rules off" to switch it off again, or "rules all" to include even rules which do not apply.

>combine harness and spool
[Rule "Check and-combining" applies.]
flag is false!

[Rule "Carry out and-combining" applies.]
[Rule "Setting action variables for combining something with something" applies.]
[Rule "Check combining it with" applies.]
[Rule "Carry out combining it with" applies.]
[Rule "Report combining it with" applies.]
You fashion the harness and the spool into a descender!

>undo
Bedroom
[Previous turn undone.]

>rules all
Rules tracing now switched to "all". Type "rules off" to switch it off again.

* * *

>actions
[Rule "Setting action variables for combining something with something" does not apply.]
[Rule "standard set going variables rule" does not apply.]
[Rule "determine visibility ceiling rule" does not apply.]
[Rule "Setting action variables for exiting" does not apply.]
[Rule "Setting action variables for sampling" does not apply.]
Actions listing on.

>undo
Bedroom
[Previous turn undone.]

>undo
Bedroom
[Previous turn undone.]

>actions
[Rule "Setting action variables for combining something with something" does not apply.]
[Rule "standard set going variables rule" does not apply.]
[Rule "determine visibility ceiling rule" does not apply.]
[Rule "Setting action variables for exiting" does not apply.]
[Rule "Setting action variables for sampling" does not apply.]
Actions listing on.

* * *

Welcome to the future.  Every citizen has been scanned, chipped, folded, spindled and mutilated - and it's enough to make you scream.

Valley of Steel
A tale of the surveillance society by The Custodian of http://everything2.com
Release 1 / Serial number 130319 / Inform 7 build 6G60 (I6/v6.32 lib 6/12N) SD

Bedroom
Your bedroom is rather boring.  It contains your bed - currently unmade - and the usual assortment of bedroom furnishings including a bedside table, next to the bed.

On the bedside table are a watch and a phone.

You can go north and west from here.

>purloin blue jacket and tag remover and knife
[Purloined.]
[Purloined.]
[Purloined.]

>cut blue jacket's tag with knife
The plastic side of the tag is folded over, attached to the garment.  You can't cut it.

>remove tag with tag remover
(the tag remover with the tag remover)
That doesn't seem possible.

>remove blue jacket's tag with tag remover
You deftly remove the tag with the tag remover.

>cut blue jacket's tag
What do you want to cut it with?

>cut blue jacket's tag with knife
You carefully cut open the tag with your knife and peel back the plastic to reveal a memory chip.

>showme blue jacket's tag
blue jacket's antitheft tag - antitheft tag
    memory chip - memory chip
location: carried by yourself in the Bedroom
singular-named, improper-named; unlit, inedible, portable, handled, disassembled; opaque, open, unopenable, unlocked; working
printed name: "blue jacket's antitheft tag"
printed plural name: "antitheft tags"
indefinite article: none
description: "This is a small, nondescript black plastic tag, perhaps a centimeter thick and four by four centimeters square, with a security loop for attaching it to products.  This tag has been cut open."
initial appearance: none
size: small
carrying capacity: 1
fryDescription: "There is a hissing noise. The plastic of the antitheft tag begins to melt."

>undo
Bedroom
[Previous turn undone.]

>i
You are carrying:
  a blue jacket's antitheft tag
    a memory chip
  a lockblade knife
  a tag remover
  a blue jacket
  a backpack (being worn and open but empty)

>w
Hall
The central hallway of your modest home.  It's relatively clean and neat, as there is no furniture in it.

You can go north, east to the Bedroom and west from here.

>w
Kitchen
Your kitchen is decorated in a style some four decades old, which is probably when it was last renovated.  It is fairly clean, reflecting the fact that you don't cook for yourself much.

You can see a refrigerator (closed), a thermos (closed) and a microwave oven here.

You can go north and east to the Hall from here.

>open oven
You open the oven.

>put blue jacket's tag in oven
You put the blue jacket's antitheft tag into the oven.

>close oven
You close the oven.

>switch oven
A light comes on in the microwave and it begins to hum.
There is a hissing noise. The plastic of the antitheft tag begins to melt.
A few moments later there is a loud BING! and the microwave stops.

>open oven
You open the oven.

>take tag
(the blue jacket's antitheft tag)
Taken.

>l tag
Which do you mean, the blue jacket's antitheft tag or the tag remover?

>l blue jacket's tag
This is a small, nondescript black plastic tag, perhaps a centimeter thick and four by four centimeters square, with a security loop for attaching it to products.  This tag has been cut open. The tag has melted slightly.  Inside you can see what looks like the remains of some electronics, but the whole mess is melted together now.

In the blue jacket's antitheft tag is a memory chip.

>restart
Are you sure you want to restart?

>yes
Welcome to the surveillance society.  Every citizen has been scanned, chipped, folded, spindled and mutilated - and it's enough to make you scream.

Valley of Steel
A tale of the surveillance society by The Custodian of http://everything2.com
Release 1 / Serial number 130317 / Inform 7 build 6G60 (I6/v6.32 lib 6/12N) SD

Bedroom
Your bedroom is rather boring.  It contains your bed - currently unmade - and the usual assortment of bedroom furnishings including a bedside table, next to the bed.

On the bedside table are a watch and a phone.

You can go north and west from here.

>purloin blue jacket and tag remover
[Purloined.]
[Purloined.]

>remove blue jacket's tag with tag remover
You deftly remove the tag with the tag remover.

>drop jacket
Dropped.

>i
You are carrying:
  a blue jacket's antitheft tag
  a tag remover
  a backpack (being worn and open but empty)

>l tag
Which do you mean, the blue jacket's antitheft tag or the tag remover?

>drop tag remover
Dropped.

>l tag
(the blue jacket's antitheft tag)
This is a small, nondescript black plastic tag, perhaps a centimeter thick and four by four centimeters square, with a security loop for attaching it to products.

>w
Hall
The central hallway of your modest home.  It's relatively clean and neat, as there is no furniture in it.

You can go north, east to the Bedroom and west from here.

* * *

>open oven
You open the oven.

>put antitheft tag in oven
You put the blue jacket's antitheft tag into the oven.

>close oven
You close the oven.

* * *

>open oven
You open the oven.

>take tag
Taken.

>l
Kitchen
Your kitchen is decorated in a style some four decades old, which is probably when it was last renovated.  It is fairly clean, reflecting the fact that you don't cook for yourself much.

You can see a refrigerator (closed), a thermos (closed) and a microwave oven here.

You can go north and east to the Hall from here.

>l tag
This is a small, nondescript black plastic tag, perhaps a centimeter thick and four by four centimeters square, with a security loop for attaching it to products. The tag has melted slightly.  Inside you can see what looks like the remains of some electronics, but the whole mess is melted together now.

>restart
Are you sure you want to restart?

>y
Welcome to the surveillance society.  Every citizen has been scanned, chipped, folded, spindled and mutilated - and it's enough to make you scream.

Valley of Steel
A tale of the surveillance society by The Custodian of http://everything2.com
Release 1 / Serial number 130317 / Inform 7 build 6G60 (I6/v6.32 lib 6/12N) SD

Bedroom
Your bedroom is rather boring.  It contains your bed - currently unmade - and the usual assortment of bedroom furnishings including a bedside table, next to the bed.

On the bedside table are a watch and a phone.

You can go north and west from here.

>purloin blue jacket and tag remover
[Purloined.]
[Purloined.]

>purloin knife
[Purloined.]

>remove blue jacket's tag with tag remover
You deftly remove the tag with the tag remover.

* * *

>drop jacket
Dropped.

>w
Hall
The central hallway of your modest home.  It's relatively clean and neat, as there is no furniture in it.

You can go north, east to the Bedroom and west from here.

* * *

>w
Kitchen
Your kitchen is decorated in a style some four decades old, which is probably when it was last renovated.  It is fairly clean, reflecting the fact that you don't cook for yourself much.

You can see a refrigerator (closed), a thermos (closed) and a microwave oven here.

You can go north and east to the Hall from here.

>l tag
Which do you mean, the blue jacket's antitheft tag or the tag remover?

>e
I only understood you as far as wanting to look east.

>drop tag remover
Dropped.

>w
You can't go that way.

>l
Kitchen
Your kitchen is decorated in a style some four decades old, which is probably when it was last renovated.  It is fairly clean, reflecting the fact that you don't cook for yourself much.

You can see a tag remover, a refrigerator (closed), a thermos (closed) and a microwave oven here.

You can go north and east to the Hall from here.

>w
You can't go that way.

>e
Hall
The central hallway of your modest home.  It's relatively clean and neat, as there is no furniture in it.

You can go north, east to the Bedroom and west to the Kitchen from here.

>w
Kitchen
Your kitchen is decorated in a style some four decades old, which is probably when it was last renovated.  It is fairly clean, reflecting the fact that you don't cook for yourself much.

You can see a tag remover, a refrigerator (closed), a thermos (closed) and a microwave oven here.

You can go north and east to the Hall from here.

>e
Hall
The central hallway of your modest home.  It's relatively clean and neat, as there is no furniture in it.

You can go north, east to the Bedroom and west to the Kitchen from here.

* * *

>w
Kitchen
Your kitchen is decorated in a style some four decades old, which is probably when it was last renovated.  It is fairly clean, reflecting the fact that you don't cook for yourself much.

You can see a tag remover, a refrigerator (closed), a thermos (closed) and a microwave oven here.

You can go north and east to the Hall from here.

>i
You are carrying:
  a blue jacket's antitheft tag
  a lockblade knife
  a backpack (being worn and open but empty)

>cut tag with knife
(the blue jacket's antitheft tag with the lockblade knife)
You carefully cut open the tag with your knife and peel back the plastic to reveal a memory chip.

>i tag
I only understood you as far as wanting to take inventory.

>l tag
(the blue jacket's antitheft tag)
This is a small, nondescript black plastic tag, perhaps a centimeter thick and four by four centimeters square, with a security loop for attaching it to products.  This tag has been cut open.

In the blue jacket's antitheft tag is a memory chip.

>take memory
Taken.

>l tag
(the blue jacket's antitheft tag)
This is a small, nondescript black plastic tag, perhaps a centimeter thick and four by four centimeters square, with a security loop for attaching it to products.  This tag has been cut open.

>l
Kitchen
Your kitchen is decorated in a style some four decades old, which is probably when it was last renovated.  It is fairly clean, reflecting the fact that you don't cook for yourself much.

You can see a tag remover, a refrigerator (closed), a thermos (closed) and a microwave oven here.

You can go north and east to the Hall from here.

>open oven
You open the oven.

>put tag in oven
(the blue jacket's antitheft tag in the microwave oven)
You put the blue jacket's antitheft tag into the oven.

>close oven
You close the oven.

>push oven button
A light comes on in the microwave and it begins to hum.
There is a hissing noise. The plastic of the antitheft tag begins to melt.
A few moments later there is a loud BING! and the microwave stops.

>open oven
You open the oven.

>take tag
(the tag remover)
Taken.

>l tag
(the tag remover)
This is a combination antitheft tag remover and wirecutter, useful for removing antitheft tags or pesky labels from products.

>e
Hall
The central hallway of your modest home.  It's relatively clean and neat, as there is no furniture in it.

You can go north, east to the Bedroom and west to the Kitchen from here.

>l tag
This is a combination antitheft tag remover and wirecutter, useful for removing antitheft tags or pesky labels from products.

>w
Kitchen
Your kitchen is decorated in a style some four decades old, which is probably when it was last renovated.  It is fairly clean, reflecting the fact that you don't cook for yourself much.

You can see a refrigerator (closed), a thermos (closed) and a microwave oven here.

You can go north and east to the Hall from here.

>drop tag remover
Dropped.

>l oven
A microwave oven of perhaps a cubic foot capacity.  It is a relatively smart oven, able to determine the proper setting for whatever is placed in it using a plethora of sensors.  There is a single button (marked "ACTIVATE") on the front. A side panel sports a lurid warning.  The door is ajar.

The microwave oven is currently switched off.

>take tag
(the tag remover)
Taken.

>drop tag remover
Dropped.

>take antitheft tag
Taken.

>e
Hall
The central hallway of your modest home.  It's relatively clean and neat, as there is no furniture in it.

You can go north, east to the Bedroom and west to the Kitchen from here.

>l tag
This is a small, nondescript black plastic tag, perhaps a centimeter thick and four by four centimeters square, with a security loop for attaching it to products.  This tag has been cut open. The tag has melted slightly.  Inside you can see what looks like the remains of some electronics, but the whole mess is melted together now.

* * *

>purloin blue jacket and tag remover and knife
[Purloined.]
[Purloined.]
[Purloined.]

>remove tag with tag remover
(the tag remover with the tag remover)
That doesn't seem possible.

* * *

>remove blue jacket's tag with tag remover
You deftly remove the tag with the tag remover.

>open tag with knife
Which do you mean, the blue jacket's antitheft tag or the tag remover?

* * *

Welcome to the future.  Every citizen has been scanned, chipped, folded, spindled and mutilated - and it's enough to make you scream.

Valley of Steel
A tale of the surveillance society by The Custodian of http://everything2.com
Release 1 / Serial number 130319 / Inform 7 build 6G60 (I6/v6.32 lib 6/12N) SD

Bedroom
Your bedroom is rather boring.  It contains your bed - currently unmade - and the usual assortment of bedroom furnishings including a bedside table, next to the bed.

On the bedside table are a watch and a phone.

You can go north and west from here.

>purlointool
That's not a verb I recognize.

>purloin tool
[Purloined.]

>gonear jukebox
The Proletariat Bar
The Proletariat is a local bar (not a pub).  It's just far enough above a "dive" to be allowed zoning here, but steadfastedly refuses to cater to upscale tastes.  You like it.  Restrooms are to the east; the bar runs along the north side, a jukebox sits against the back wall, and the rest of the space is filled with bar tables.  A few hardy drinkers sit here, communing with their spirits.  In a nod to the place's name, a Public Surveillance Notice covered with stickers and graffiti tags has been framed above the bar.

You can go northwest, southwest, east and west from here.

>w
Green Commercial Plaza Center
This is the center of the Green Commercial Plaza.  There is a fountain here with a bench facing it.  The plaza continues to the north and south; to the east is a bar called (ironically, you hope) the Proletariat.  To the west is a Bistro Paris cafe.

You can see a trash can (closed) here.

You can go north, northeast, northwest, south, southeast, east to The Proletariat Bar and west from here.

There is a Public Surveillance Notice here.

>open solar panel with tool
That doesn't seem to be something you can unlock.

>actions
Actions listing on.

>open solar panel with tool
[unlocking the solar panel with the multitool]
That doesn't seem to be something you can unlock.
[unlocking the solar panel with the multitool - failed the can't unlock without a lock rule]

>rules
Rules tracing now switched on. Type "rules off" to switch it off again, or "rules all" to include even rules which do not apply.

>open solar panel with tool
[unlocking the solar panel with the multitool]
[Rule "can't unlock without a lock rule" applies.]
That doesn't seem to be something you can unlock.
[unlocking the solar panel with the multitool - failed the can't unlock without a lock rule]

[Rule "Every Turn during Transit Stop" applies.]

>gonear side panel
[Rule "determine visibility ceiling rule" applies.]
[(1) looking]
[Rule "room description heading rule" applies.]
Kitchen
[Rule "room description body text rule" applies.]
Your kitchen is decorated in a style some four decades old, which is probably when it was last renovated.  It is fairly clean, reflecting the fact that you don't cook for yourself much.

[Rule "room description paragraphs about objects rule" applies.]
[Rule "don't mention player's supporter in room descriptions rule" applies.]
[Rule "don't mention scenery in room descriptions rule" applies.]
[Rule "don't mention undescribed items in room descriptions rule" applies.]
[Rule "set pronouns from items in room descriptions rule" applies.]
[Rule "offer items to writing a paragraph about rule" applies.]
[Rule "use initial appearance in room descriptions rule" applies.]
[Rule "describe what's on scenery supporters in room descriptions rule" applies.]
[Rule "don't mention player's supporter in room descriptions rule" applies.]
[Rule "don't mention scenery in room descriptions rule" applies.]
[Rule "don't mention undescribed items in room descriptions rule" applies.]
[Rule "set pronouns from items in room descriptions rule" applies.]
[Rule "offer items to writing a paragraph about rule" applies.]
[Rule "use initial appearance in room descriptions rule" applies.]
[Rule "describe what's on scenery supporters in room descriptions rule" applies.]
[Rule "don't mention player's supporter in room descriptions rule" applies.]
[Rule "don't mention scenery in room descriptions rule" applies.]
[Rule "don't mention undescribed items in room descriptions rule" applies.]
[Rule "set pronouns from items in room descriptions rule" applies.]
[Rule "offer items to writing a paragraph about rule" applies.]
[Rule "use initial appearance in room descriptions rule" applies.]
[Rule "describe what's on scenery supporters in room descriptions rule" applies.]
[Rule "don't mention player's supporter in room descriptions rule" applies.]
[Rule "don't mention scenery in room descriptions rule" applies.]
[Rule "don't mention undescribed items in room descriptions rule" applies.]
[Rule "set pronouns from items in room descriptions rule" applies.]
[Rule "offer items to writing a paragraph about rule" applies.]
[Rule "use initial appearance in room descriptions rule" applies.]
[Rule "describe what's on scenery supporters in room descriptions rule" applies.]
You can see a refrigerator (closed), a thermos (closed) and a microwave oven here.

[Rule "check new arrival rule" applies.]
[Rule "explosive residue rule" applies.]
[Rule "exits rule" applies.]
[Rule "darkness hides exits rule" applies.]
[Rule "darkness hides exits rule" applies.]
You can go [Rule "darkness hides exits rule" applies.]
[Rule "darkness hides exits rule" applies.]
north and east from here.

[Rule "list notable events rule" applies.]
[Rule "other people looking rule" applies.]
[(1) looking - succeeded]

I beg your pardon?

>open side panel with tool
[unlocking the side panel with the multitool]
[Rule "instead of unlocking the side panel with the multitool" applies.]
[(1) opening the side panel with the multitool]
[Rule "Check opening the side panel with something" applies.]
[Rule "Carry out opening it with" applies.]
You pry open the side panel with the pliers in your multitool, ignoring the sound of breaking plastic.

[(1) opening the side panel with the multitool - succeeded]

[unlocking the side panel with the multitool - succeeded]

[Rule "Every Turn during Transit Stop" applies.]
[Rule "scene description text rule" applies.]

* * *

Welcome to the future.  Every citizen has been scanned, chipped, folded, spindled and mutilated - and it's enough to make you scream.

Valley of Steel
A tale of the surveillance society by The Custodian of http://everything2.com
Release 1 / Serial number 130319 / Inform 7 build 6G60 (I6/v6.32 lib 6/12N) SD

Bedroom
Your bedroom is rather boring.  It contains your bed - currently unmade - and the usual assortment of bedroom furnishings including a bedside table, next to the bed.

On the bedside table are a watch and a phone.

You can go north and west from here.

>actions
Actions listing on.

>purloin tag remover and memory
[Purloined.]
[Purloined.]

>gonear id camera
[(1) looking]
Booking
This area is used for processing prisoners…er, excuse me, suspects, and as a waiting lounge.  There is a single hard bench, now empty, and a counter along the south wall with a stern poster on the wall above it.  One area has been kept clear and is a neutral pale blue, presumably to be used as a backdrop for photographing suspects.

You can see an ID camera here.

You can go north from here.

[(1) looking - succeeded]

>cut chain with tag remover
[cutting the camera chain with the tag remover]
Looking around to check for watchers, you snip through the ID chain with the tag remover!
[cutting the camera chain with the tag remover - succeeded]

>take id camera
[taking the ID camera]
Taken.
[taking the ID camera - succeeded]

>put memory in id camera
[inserting the memory chip into the ID camera]
[(1) inserting the memory chip into the camera slot]
You put the memory chip into the camera slot.
[(1) inserting the memory chip into the camera slot - succeeded]

[inserting the memory chip into the ID camera - succeeded]

>gonear zuzu's eye
[(1) looking]
Green Commercial Bistro Paris
This is a branch of the popular lunch and coffee shop Bistro Paris.  Counter service is available for pastries, drinks and light sandwiches. There are a few tables near the front for sit-down meals.  A restroom is to the west.  On the north wall, opposite the service counter, is a collection of Paris-themed prints.  In the center is a large holoportrait of the chain's owner, Zuzu, and a sign claiming that the Bistro Paris has restaurants here, in the Reserve Bank Spacescraper, and in London.

You can see a trash can (closed) here.

You can go northeast, southeast, east and west from here.

[(1) looking - succeeded]

>photograph zuzu's eye with id camera
[photographing Zuzu's eye]
The camera emits an artificial-sounding "CLICK" noise.
  The Memory icon flashes green, indicating that the camera's tiny onboard storage is full.
[photographing Zuzu's eye - succeeded]

>se
[going southeast]

Green Commercial Plaza South
The southern end of the Green Commercial Plaza, which continues to the north.  To the east is Accessorize, a fashion store, and to the west is Garb-oh, a trendy clothing shop.  The south end of the mall is closed off by an elaborate landscaping installation of trees and shrubs, presumably to hide a relatively ugly building behind it.

You can see a trash can (closed) here.

You can go north, northeast, northwest to the Green Commercial Bistro Paris, east and west through the Garb-oh door (closed) from here.

There is a Public Surveillance Notice here.
[going southeast - succeeded]

>e
[going east]

Accessorize
This well-lit store purveys all manner of cosmetic aids and fashion accessories.  Everything from wrist bangles to skin creams to custom cosmetic contacts can be purchased here.

You can see a Lens Crafter here.

You can go northwest and west to Green Commercial Plaza South from here.

There is a Public Surveillance Notice here.
[going east - succeeded]

>put memory in lens crafter
[inserting the memory chip into the Lens Crafter]
[(1) inserting the memory chip into the crafter slot]
You put the memory chip into the crafter slot.
[(1) inserting the memory chip into the crafter slot - succeeded]

[inserting the memory chip into the Lens Crafter - succeeded]

>switch on lens crafter
[switching on the Lens Crafter]
The lens crafter machine's screen flashes green.  A message reads "SOURCE DATA ACCEPTED - COSTUME LENS SYNTHESIZED."  The machine hisses slightly, and a sleeve descends around the lens case.  When the sleeve retracts, the lens case is closed.
[switching on the Lens Crafter - succeeded]

>showme contact lens
contact lens - thing
location: in the lens case in the delivery slot , which is part of the Lens Crafter in Accessorize
singular-named, improper-named; unlit, inedible, portable, wearable, assembled
printed name: "contact lens"
printed plural name: none
indefinite article: none
description: "Larger than a regular contact lens, this example is discolored around the edges although clear in the middle."
initial appearance: none
size: tiny

>showme lens crafter
Lens Crafter - device
    delivery slot (part of Lens Crafter) - open container
    Lens Crafter's activate button (part of Lens Crafter) - activate button
    Lens Menu (part of Lens Crafter)
    crafter slot (part of Lens Crafter) - open container
        memory chip - memory chip
        lens case - transparent closed container
            contact lens
location: in Accessorize
singular-named, improper-named; unlit, inedible, fixed in place, assembled; switched off; fried
printed name: "Lens Crafter"
printed plural name: "devices"
indefinite article: none
description: "A floor-standing device used to produce custom-made cosmetic contact lenses (although for an extra fee, they can be made to a prescription).  A screen on the front presents a menu of options, or a Memory can be inserted into a slot with appropriate specifications."
initial appearance: none
size: medium

>push lens crafter button
[switching on the Lens Crafter]
The screen flashes red.  A message reads "INSUFFICIENT STOCK."
[switching on the Lens Crafter - ended without result]

* * *

Welcome to the future.  Every citizen has been scanned, chipped, folded, spindled and mutilated - and it's enough to make you scream.

Valley of Steel
A tale of the surveillance society by The Custodian of http://everything2.com
Release 1 / Serial number 130319 / Inform 7 build 6G60 (I6/v6.32 lib 6/12N) SD

Bedroom
Your bedroom is rather boring.  It contains your bed - currently unmade - and the usual assortment of bedroom furnishings including a bedside table, next to the bed.

On the bedside table are a watch and a phone.

You can go north and west from here.

>take phone
Taken.

* * *

>w
Kitchen
Your kitchen is decorated in a style some four decades old, which is probably when it was last renovated.  It is fairly clean, reflecting the fact that you don't cook for yourself much.

You can see a refrigerator (closed), a thermos (closed) and a microwave oven here.

You can go north and east to the Hall from here.

>open side panel with phone
You can't disassemble the side panel with that.

>actions
Actions listing on.

>open side panel with phone
[unlocking the side panel with the phone]
[unlocking the side panel with the phone - succeeded]

>rules
Rules tracing now switched on. Type "rules off" to switch it off again, or "rules all" to include even rules which do not apply.

>open side panel with phone
[unlocking the side panel with the phone]
[unlocking the side panel with the phone - succeeded]

[Rule "Every Turn during Transit Stop" applies.]
[Rule "scene description text rule" applies.]

* * *

>open side panel with phone
You can't disassemble the side panel with that.

>rules
Rules tracing now switched on. Type "rules off" to switch it off again, or "rules all" to include even rules which do not apply.

>open side panel with phone
[Rule "Every Turn during Transit Stop" applies.]

>actions
Actions listing on.

>open side panel with phone
[unlocking the side panel with the phone]
[unlocking the side panel with the phone - succeeded]

[Rule "Every Turn during Transit Stop" applies.]
[Rule "scene description text rule" applies.]

>open side panel with tool
You can't see any such thing.

>i
[taking inventory]
[Rule "print empty inventory rule" applies.]
[Rule "print standard inventory rule" applies.]
You are carrying:
  a phone
  a backpack (being worn and open but empty)

[Rule "report other people taking inventory rule" applies.]
[taking inventory - succeeded]

>purloin multitool
[Purloined.]

>open side panel with tool
[unlocking the side panel with the multitool]
[Rule "instead of unlocking the side panel with the multitool" applies.]
[(1) opening the side panel with the multitool]
[Rule "Check opening the side panel with something" applies.]
[Rule "Carry out opening it with" applies.]
You pry open the side panel with the pliers in your multitool, ignoring the sound of breaking plastic.

[(1) opening the side panel with the multitool - succeeded]

[unlocking the side panel with the multitool - succeeded]

[Rule "Every Turn during Transit Enroute" applies.]

* * *

>open side panel with phone
You can't disassemble the side panel with that.

>purloin multitool
[Purloined.]

>open side panel with tool
You pry open the side panel with the pliers in your multitool, ignoring the sound of breaking plastic.

>purloin key and knife
[Purloined.]
[Purloined.]

>open key with knife
That's not something you can open.

>open key
That's not something you can open.

>open key with knife
That's not something you can open.

>cut key with knife
You carefully cut open the car keys with your knife and peel back the rubber to reveal a broadcast chip and a memory chip.

>undo
Kitchen
[Previous turn undone.]

>cut key
What do you want to cut it with?

>gonear jukebox
The Proletariat Bar
The Proletariat is a local bar (not a pub).  It's just far enough above a "dive" to be allowed zoning here, but steadfastedly refuses to cater to upscale tastes.  You like it.  Restrooms are to the east; the bar runs along the north side, a jukebox sits against the back wall, and the rest of the space is filled with bar tables.  A few hardy drinkers sit here, communing with their spirits.  In a nod to the place's name, a Public Surveillance Notice covered with stickers and graffiti tags has been framed above the bar.

You can go northwest, southwest, east and west from here.

* * *

>e
Proletariat restroom
The one-holer restroom at the Proletariat is cleaner than you might think, although that may be due to the fact that it is midweek.  A scratched mirror over the sink has been covered with marker graffiti.

You can see a trash can (closed) here.

You can go west to The Proletariat Bar from here.

>put knife in pack
You put the lockblade knife into the backpack.

>open trash can
You open the trash can, revealing some rubbish.

>restart
Are you sure you want to restart?

>yes
Welcome to the surveillance society.  Every citizen has been scanned, chipped, folded, spindled and mutilated - and it's enough to make you scream.

Valley of Steel
A tale of the surveillance society by The Custodian of http://everything2.com
Release 1 / Serial number 130315 / Inform 7 build 6G60 (I6/v6.32 lib 6/12N) SD

Bedroom
Your bedroom is rather boring.  It contains your bed - currently unmade - and the usual assortment of bedroom furnishings including a bedside table, next to the bed.

On the bedside table are a watch and a phone.

You can go north and west from here.

>actions
Actions listing on.

* * *

>rules
Rules tracing now switched on. Type "rules off" to switch it off again, or "rules all" to include even rules which do not apply.

>purloin key and knife
[Purloined.]
[Purloined.]

>open key with knife
[opening the car key with the lockblade knife]
[Rule "Carry out opening it with" applies.]
[(1) opening the car key]
[Rule "can't open unless openable rule" applies.]
That's not something you can open.
[(1) opening the car key - failed the can't open unless openable rule]

[opening the car key with the lockblade knife - succeeded]

* * *

Welcome to the future.  Every citizen has been scanned, chipped, folded, spindled and mutilated - and it's enough to make you scream.

Valley of Steel
A tale of the surveillance society by The Custodian of http://everything2.com
Release 1 / Serial number 130319 / Inform 7 build 6G60 (I6/v6.32 lib 6/12N) SD

Bedroom
Your bedroom is rather boring.  It contains your bed - currently unmade - and the usual assortment of bedroom furnishings including a bedside table, next to the bed.

On the bedside table are a watch and a phone.

You can go north and west from here.

>purloin knife and key
[Purloined.]
[Purloined.]

>open car key with knife
You carefully cut open the car keys with your knife and peel back the rubber to reveal a broadcast chip and a memory chip.

>undo
Bedroom
[Previous turn undone.]

>actions
Actions listing on.

* * *

>rules
Rules tracing now switched on. Type "rules off" to switch it off again, or "rules all" to include even rules which do not apply.

>open car key with knife
[opening the car key with the lockblade knife]
[Rule "Carry out opening it with" applies.]
[(1) cutting the car key with the lockblade knife]
[Rule "Check cutting the car key with something" applies.]
[Rule "Check cutting it with" applies.]
[Rule "Carry out cutting the car key with something" applies.]
You carefully cut open the car keys with your knife and peel back the rubber to reveal a broadcast chip and a memory chip.

[(1) cutting the car key with the lockblade knife - succeeded]

[opening the car key with the lockblade knife - succeeded]

* * *

Welcome to the future.  Every citizen has been scanned, chipped, folded, spindled and mutilated - and it's enough to make you scream.

Valley of Steel
A tale of the surveillance society by The Custodian of http://everything2.com
Release 1 / Serial number 130319 / Inform 7 build 6G60 (I6/v6.32 lib 6/12N) SD

Bedroom
Your bedroom is rather boring.  It contains your bed - currently unmade - and the usual assortment of bedroom furnishings including a bedside table, next to the bed.

On the bedside table are a watch and a phone.

You can go north and west from here.

>purloin harness and spool
[Purloined.]
[Purloined.]

>combine harness and spool
flag is false!

You fashion the harness and the spool into a descender!

That isn't available.

>undo
Bedroom
[Previous turn undone.]

* * *

>rules
Rules tracing now switched on. Type "rules off" to switch it off again, or "rules all" to include even rules which do not apply.

>actions
Actions listing on.

>combine harness and spool
[and-combining the harness]
[Rule "Check and-combining" applies.]
flag is false!

[Rule "Carry out and-combining" applies.]
[Rule "Setting action variables for combining something with something" applies.]
[(1) combining the harness with the spool]
[Rule "Check combining it with" applies.]
[Rule "Carry out combining it with" applies.]
[Rule "Report combining it with" applies.]
You fashion the harness and the spool into a descender!
[(1) combining the harness with the spool - succeeded]

[and-combining the harness - succeeded]
[and-combining the spool]
That isn't available.
[and-combining the spool - failed the basic accessibility rule]

>undo
Bedroom
[Previous turn undone.]

>i
[taking inventory]
[Rule "print empty inventory rule" applies.]
[Rule "print standard inventory rule" applies.]
You are carrying:
  a spool
  a harness
  a backpack (being worn and open but empty)

[Rule "report other people taking inventory rule" applies.]
[taking inventory - succeeded]

>rules all
Rules tracing now switched to "all". Type "rules off" to switch it off again.

* * *

>purloin harness and spool
[Purloined.]
[Purloined.]

>attach harness and spool
You fashion the harness and the spool into a descender!

>i
You are carrying:
  a descender
  a backpack (being worn and open but empty)