A rare moment of rest.  Your mission to steal specifications of the MitKlein Encapsulation - the ID transponder embedded in every citizen's head, even yours - was successful, and you transmitted your report to Central early this morning.   You expect a new assignment soon, even if it is only instructions to fall back into a cover identity, as you have been on the front lines of the underground struggle against Homeland Security nearly from the start.  Giving up your birth identity and life, moving instead into the flickery half-existence of an underground operative, you've sabotaged, stolen, publicized, verified and fought for years now.  Hopefully, this last mission means that a strategy to counter the government's ubiquitous tagging of citizens is being worked out at levels above your own head.

For now, you have found yourself a small quiet park in a quiet corner of the City.

Welcome to the future.  Every citizen has been scanned, chipped, folded, spindled and mutilated - and it's enough to make you scream.

Valley of Steel
A tale of the surveillance society by The Custodian of http://everything2.com
Release 3 / Serial number 140330 / Inform 7 build 6G60 (I6/v6.32 lib 6/12N) SD

Green Residential Park
Primrose Street ends here in a small circular cul-de-sac.  You're in a small green park to the north of this, bounded on its three other sides by high fences.  A few trees rise over well-manicured grass.  There is a curfew sign at the park's entrance.

The Reserve Bank Spacescraper is visible in the distance, rising over the low skyline.

You can go south from here.

There is a Public Surveillance Notice here.

>gonear lift lobby
Lift Lobby
The Lift Lobby controls underground access to the Reserve Bank spacescraper, beneath the towers of industry and capital made pillars of money and sin.  Hundreds of people rush to and fro through the lobby on their way into or out of the building.  To the north is a large bank of bouncelifts, their liftfields on and glowing faintly blue behind security gates.  Access to the bouncelifts is controlled by Lift Scanners, set above and to the right of each bouncelift entry.  There is no ceiling; several meters up, the room opens out into the street level lobby above.  There is a railing around the perimeter of the floor above; several people are leaning against or over it, watching the flow of commuters below them and around you.  The Atrium, a wide open area extending at least halfway up the spacescraper, is visible above that. There is no way to reach the street lobby from here other than via the bouncelifts. A shallow ramp leads east down to the Food Court.

You can hear the confused murmur of a large crowd coming from the Atrium above.

You can see a Powered Platform (on which is a spool) and the Security Guard here.

You can go east and up from here.

>e
Food Court
The center of the Food Court beneath the Reserve Bank spacescraper is a busy place at all times of the day.  Around the periphery are several food stand franchises, some doing a brisk business.  Dozens of customers are here waiting in line at the food stands, sitting at the dozens of tables in the center, or just passing through from the Reserve Bank Station to the Lift Lobby up a ramp to the west or vice versa.  The floor is made of duramex tiles.

The food stands here are Reserve Bank Bistro Paris, I Have No Mouth, The Sheep Look Up, Tacos Terriff, and Apollo's.

You can see a trash can (closed) here.

You can go northwest, east, and west to Lift Lobby from here.

There is a Public Surveillance Notice here.

* * *

>read sign
A sturdy metal sign, it reads "NOTE: PARK CLOSED DURING GREEN RESIDENTIAL AREA CURFEW - 8:00PM to 5:00 AM - NO LOITERING."

>s
Primrose & Station
This staid neighborhood intersection of Primrose Lane and Cedar Street fronts the local Transit station, Green Residential.  The station entrance is to the west.  Primrose Lane continues to the south.

The Reserve Bank Spacescraper is visible in the distance, rising over the low skyline.

You can go north to Green Residential Park, south, and west from here.

There is a Public Surveillance Notice here.

>s
South Primrose Lane
Primrose Lane continues to the north.  To the south is a boarded-up empty house; sumac plants can be seen peeking over the top of the dilapidated fencing.  The fence has a plastic tarp strung behind it which prevents you from seeing much of the house.  To the west is a single-family home with a large warning sign and an enormous dog on the front lawn.  To the east is a three-family residence's front path.

The Reserve Bank Spacescraper is visible in the distance, rising over the low skyline.

You can go north to Primrose & Station and east from here.

There is a Public Surveillance Notice here.

>x dog
This snoozing beast must mass thirty kilos or more.  Its ancestry appears to include Mastiff, Doberman Pinscher, Rottweiler and tribble. You have no desire to get anywhere near it.

>e
Front Path
This front path is paved with cracked flagstones.  Primrose Lane is to the west, a three-family building is to the east, and the building's side yard is to the northeast.

The Reserve Bank Spacescraper is visible in the distance, rising over the low skyline.

You can go northeast, east through the House door (closed), and west to South Primrose Lane from here.

There is a Public Surveillance Notice here.

>ne
Side Yard
A narrow side yard with a high solid fence on the north side and a few straggly decorative plants.  The yard extends east behind the house and west to the front of the house.

The Reserve Bank Spacescraper is visible in the distance, rising over the low skyline.

You can go east and west to Front Path from here.

There is a Public Surveillance Notice here.

There is a quiet tone from your phone and you feel a short vibration, indicating that an SMS message has arrived.

>e
Back Yard
An enclosed back yard, this small square of grass is surrounded by a high fence and the east side of the attached home.  A narrow frosted window - likely a bathroom - is visible in the middle of the stretch of wall, and a larger clear window with curtains behind it is visible at the south end.

The Reserve Bank Spacescraper is visible in the distance, rising over the low skyline.

You can go north to Side Yard from here.

There is a Public Surveillance Notice here.

>x bedroom window
A large clear two-pane window, it is locked with a latch mechanism at the join of the two panes.  Having the latch on the outside probably violates some building code somewhere.

>x latch
This is a fairly standard window latch.  It prevents the two windowpanes from sliding past one another.  The locking tab is secured with a cotter pin which, for some reason, is on the outside of the window.

In the latch is a cotter pin.

>x multitool
Your pocket multitool.  Has various pliers and attachments and, in a pinch, can probably do 80 percent of what a full toolbox could.  One exception is that in order to remain legal, it doesn't have any cutting edges larger than your fingernail.  You are paranoid that one day you'll forget and try to get on an airplane with it and despite that fact that'll be the last you'll see of it, so you've etched a PO Box address and "BUSINESS REPLY MAIL" onto it.

[The multitool is useful for prying or as a pliers.  To use it, try commands with the phrase WITH MULTITOOL - for example, OPEN <NOUN> WITH MULTITOOL or REMOVE <NOUN> WITH MULTITOOL.]

>remove pin with multitool
You deftly remove the cotter pin with the multitool.

>open bedroom window
You slide the bedroom window open.

>w
Bedroom
This bedroom is rather plain.  Its owners must not spend much time in it while awake.  It contains a bed - currently unmade - and a bedside table with a lamp on it.  Cheap curtains partially cover the window.

You can go north, east to Back Yard, and west from here.

>n
Bathroom
This home only has the one bathroom, which means that the fact that it's not very clean is somewhat embarrassing.  Or at least, it would be if the owner had expected visitors. It contains a sink, mirror, toilet and shower.

You can go south to Bedroom and west from here.

>x shower
A one-piece shower unit.

>x mirror
A mid-range but functional mirror mounted over the sink.  It has various illegible smudges around the edge which suggest that its owner uses it to write temporary notes to themself.  One corner has a small piece of graffiti done in black marker.

>x graffiti
This small graffito is a small figure, flying, wearing a cape. Just below it is a URL: http://bit.ly/18O4POl

>w
Entry
This is the small entryway to the ground-floor apartment. A pile of mail, most of it unread, nearly covers the side table just inside the apartment door.  The apartment hallway is to the south.  To the west is an office, and to the east is a bathroom.

You can see a side table (on which is a car key) here.

You can go north through the Apartment door (closed), south, east to Bathroom, and west from here.

A quiet tone from your phone indicates that you have unread SMS messages.

>get car key
Taken.

>x fob
This "key" is really a small rubberized, sealed plastic fob which automatically unlocks the car it is paired with when it is within range.  You have no idea where the appropriate car might be, however.

>w
Home Office
This is obviously a home office, a room which in other homes might be a living room. It is not very tidy.  Random detritus covers most available surfaces except for a workbench.

You can see a workbench (on which are a lockblade knife, a soldering iron, some solder, and a tablet computer) here.

You can go south and east to Entry from here.

>take all
lockblade knife: This knife is large enough to run afoul of local weapons laws.  It would be a bad idea to let it be seen where the police are watching.
soldering iron: Taken.
solder: Taken.
tablet computer: Taken.

>x tablet
The tablet is a generic, slightly more fashionable than functional portable tablet computer. It is active, with the screen lit.

>x screen
The tablet is presently displaying a lock screen.  There is a reboot button in the corner of the screen.

>reboot tablet
The screen flickers as the tablet reboots.  The tablet pauses as it finds the boot server that has been installed on your phone, and then there is a quick series of flashes before a screen full of text comes up!

>read sms
Message 1 reads: REPORT RECEIVED.  MISSION SUCCESSFUL.  ATTACK PROGRAM CREATED USING INFORMATION IN REPORT. <more>

>g
Message 2 reads: DANGER DANGER DANGER:  OPERATIVE COMPROMISED DURING OPERATION.  YOUR MITKLEIN CODE READ BY HOMELAND SECURITY.  YOUR ID RECORDS DELETED BUT MITKLEIN CODE ALONE ENOUGH TO ID YOU AS TARGET.<more>

>g
Message 3 reads: NEW INSTRUCTIONS FOLLOW: <more>

>g
Message 4 reads: - YOU MUST FIND A WAY TO DISABLE YOUR MITKLEIN USING ATTACK PROGRAM WHICH WILL BE DELIVERED<more>

>g
Message 5 reads: - YOU MUST NOT BE IN SURVEILLED AREA DURING CURFEW WITH ACTIVE MITKLEIN OR SECURITY SWEEPS WILL IDENTIFY YOU AS TARGET<more>

>g
Message 6 reads: - YOU MUST NOT BE ID-SCANNED UNTIL MITKLEIN IS DISABLED<more>

>g
Message 7 reads: - ONCE MITKLEIN IS DISABLED, RETRIEVE DROP MESSAGE FOR NEW INSTRUCTIONS.  CONTACT WILL LEAVE DROP MESSAGE NEAR FOUNTAIN IN GREEN COMMERCIAL.<more>

>g
Message 8 reads: - ATTACK PROGRAM AVAILABLE FOR DOWNLOAD BY NETBOOTING ANY COMPUTER WITH YOUR PHONE IN PROXIMITY<more>

>g
Message 9 reads: - THIS PHONE POSSIBLY COMPROMISED - IF IT ACQUIRES CELL SIGNAL IN ANOTHER AREA IT WILL BE LOCATABLE BY HOMELAND SECURITY - DISABLE ENTIRELY OR ABANDON BEFORE TRAVEL<more>

>g
Message 10 reads: GOOD LUCK. MESSAGE ENDS.

>cut fob with knife
You carefully cut open the car key with your knife and peel back the rubber to reveal a broadcast chip and a transponder memory chip.

>take memory chip
Taken.

>put memory in chipslot
The Download light flashes red intermittently for a few seconds before returning to a regular blinking green.

>take memory
Taken.

>put key in pack
You put the car key into the backpack.

>solder attack to broadcast
You fashion the attack memory chip and the broadcast chip into a Klein Blaster!

>put knife in pack
You put the lockblade knife into the backpack.

>s
Kitchen
This kitchen is decorated in a style some four decades old, which is probably when it was last renovated.  It is fairly clean, likely reflecting the fact that the occupants don't cook for themselves much.  The built-in sink takes up most of the available counter space, with the microwave oven occupying almost all of the rest.  The refrigerator hulks along the opposite wall.

You can go north to Home Office and east from here.

>x microwave
(the microwave oven)
A microwave oven of perhaps a cubic foot capacity with a transparent door.  It is a relatively smart oven, able to determine the proper setting for whatever is placed in it using a plethora of sensors.  There is a single button (marked "COOK") on the front. A side panel sports a lurid warning.

The microwave oven is currently switched off.

>open panel with multitool
You pry open the side panel with the pliers in your multitool, ignoring the sound of breaking plastic.

Opening the side panel reveals the safety limiter!

>take limiter
Taken.

>put limiter in pack
You put the safety limiter into the backpack.

>microwave phone
You put the phone into the oven.

A light comes on in the microwave and it begins to hum.
Almost immediately, sparks begin to dance wildly around the rim of the phone! After a few seconds more, the screen goes dead black with a very final ZZT noise.
A few moments later there is a loud BING! and the microwave stops.

>take phone
The oven isn't open.

>open oven
You open the oven.

>take phone
Taken.

>x phone
A standard candybar model with a nice screen.  At least, the screen was nice; now it's stone dead.  The back is blank metal save for a tiny icon of a waterdrop with a slash across it.

>solder klein blaster to oven
As you slide the component in, a small LED labelled "TRNSMT RDY" lights up on the main board!

You put the Klein Blaster into the side panel.

>undo
Kitchen
[Previous turn undone.]

>put klein blaster into panel
As you slide the component in, a small LED labelled "TRNSMT RDY" lights up on the main board!

You put the Klein Blaster into the side panel.

>open oven
That's already open.

>push cook button
With the door open, the hacked microwave keeps increasing its power as energy is lost to the air.  You feel an incredible burst of noise behind your forehead!  Static, bits of music, and above all the shriek of data transfer!  Just before you feel you'll go mad from the noise, there is a stutter, and it stops.  Blessed silence falls inside your skull.  There is a smell of smoke as the microwave goes dead.

You examine the now-fried microwave, musing to yourself that if only there was a way to make a portable version of this hack, you might be able to fight your way clear of this whole mess.

>n
Home Office
This is obviously a home office, a room which in other homes might be a living room. It is not very tidy.  Random detritus covers most available surfaces except for a workbench.

You can see a workbench here.

You can go south to the Kitchen and east to Entry from here.

>e
Entry
This is the small entryway to the ground-floor apartment. A pile of mail, most of it unread, nearly covers the side table just inside the apartment door.  The apartment hallway is to the south.  To the west is an office, and to the east is a bathroom.

You can see a side table here.

You can go north through the Apartment door (closed), south, east to Bathroom, and west to Home Office from here.

>n
(first opening the Apartment door)
You undo the throw bolts.  Since you have no key, you leave the door unlocked.

Front Lobby
The slightly shabby front lobby of this multi-family building.  A door leads outside to the west, gated stairs leading up to the upper two floors are to the east, and an apartment door is to the south.

A small post-it note is stuck to the door of Apartment 1.

You can also see a newspaper and a pamphlet here.

You can go south through the Apartment door to Entry and west through the House door (closed) to Front Path from here.

There is a Public Surveillance Notice here.

>read newspaper
Today's front-page headline is: Homeland Security convention to be held this week at the Reserve Bank Spacescraper.   "The best and the brightest of the various Homeland Security agencies will meet in the Reserve Bank Atrium this week to receive presentations on new security initiatives and to discuss the state of the art in security technology."

The next headline reads: Possible Artificial Intelligence breakthrough!
The story itself continues: "Researchers at an area university have issued conflicting press statements as to whether a recent AI incubation experiment has ended in success or failure.  One graduate student, who appeared to be in tears, would only say "Pyrrhic.  It was so unnecessary."" At the bottom, a small postscript reads Would you like to know more?  http://bit.ly/17I7fzC  

Reading the story about the Homeland Security convention, the thought of all those Homeland Security drones in one place makes you grind your teeth.  Then, however, a vision of all those heavily-secured workers with dead MitKlein bottles replaces it, and you have some difficulty wiping the resulting smile from your face.  If only...

>read note
A short scribble, which reads "The techs were by to turn off your water.  Have a nice vacation!"

>put note and newspaper in pack
post-it: Done.
newspaper: Done.

>w
(first opening the House door)

Front Path
This front path is paved with cracked flagstones.  Primrose Lane is to the west, a three-family building is to the east, and the building's side yard is to the northeast.

The Reserve Bank Spacescraper is visible in the distance, rising over the low skyline.

You can go northeast to Side Yard, east through the House door to Front Lobby, and west to South Primrose Lane from here.

There is a Public Surveillance Notice here.

The automatic door slides closed.

>x flagstones
Weathered stones, which appear to be naturally smooth rather than having been shaped.

>w
South Primrose Lane
Primrose Lane continues to the north.  To the south is a boarded-up empty house; sumac plants can be seen peeking over the top of the dilapidated fencing.  The fence has a plastic tarp strung behind it which prevents you from seeing much of the house.  To the west is a single-family home with a large warning sign and an enormous dog on the front lawn.  To the east is a three-family residence's front path.

The Reserve Bank Spacescraper is visible in the distance, rising over the low skyline.

You can go north to Primrose & Station and east to Front Path from here.

There is a Public Surveillance Notice here.

>w
As you approach the lawn of the house, the large dog raises its head to look at you and growls, softly but very communicatively.  You decide discretion is the better part of valor and retreat.

>x sign
It reads "YOUR SKIN MUST BE THIS THICK (here there is a lifelike picture of a dog's tooth, perhaps an inch long) TO BURGLE THIS HOUSE."  There is an arrow pointing down and to the side, which actually points at the dog.

>x fence
A combination of cyclone fence - interleaved wire - with plastic sheeting hung behind, it blocks your view.  You can hear rustling and low murmuring from behind it, as of people moving around and talking furtively.

>x tarp
A combination of cyclone fence - interleaved wire - with plastic sheeting hung behind, it blocks your view.  You can hear rustling and low murmuring from behind it, as of people moving around and talking furtively.

>climb fence
The gaps are too small for your toes and you're not strong enough to climb it with only your fingers.

>s
You can't see any holes in the fence.

You have the sudden feeling that you're being followed, but have no idea by whom.

>n
Primrose & Station
This staid neighborhood intersection of Primrose Lane and Cedar Street fronts the local Transit station, Green Residential.  The station entrance is to the west.  Primrose Lane continues to the south.

The Reserve Bank Spacescraper is visible in the distance, rising over the low skyline.

You can go north to Green Residential Park, south to South Primrose Lane, and west from here.

There is a Public Surveillance Notice here.

>w
Green Residential Station
This is a utilitarian shelter intended mostly to keep the rain out of the Transit System.  A stairway leads down to the autodoor leading to the Transit platform and an exit leads east to the street.

You can go east to Primrose & Station and down through the Green Residential Station door (closed) from here.

There is a Public Surveillance Notice here.

>d
(first opening the Green Residential Station door)
The Door Scanner scans your iris to determine your identity.  The Transit Security and Accounting Subroutine determines that you have a legitimate account with the Transit system, and the doors slide smoothly open.

Green Residential Platform
Green Residential's platform serves mostly residential commuters.  There is an exit at the center of the platform which leads east through a set of closed automatic doors to a stairway leading up to the main station, just next to a large plaque with the name of the station on it.  The platform abuts the Transit web to the west, now empty.

[NOTE: Welcome to Transit.  You can WAIT FOR CAPSULE in stations, and WAIT FOR <station name> on board.]

You can see a Transit Map here.

You can go east through the Green Residential Station door to Green Residential Station from here.

There is a Public Surveillance Notice here.

The automatic door slides closed.

>x web
Not really a web so much as a series of maglev rings linked by guides, the Transit Web is separated from the platform by a barrier fence with automatic doors, which line up with Transit Capsule doors when a Capsule is in the station.  The Web rings glow faintly with the Magfield.

>x autodoors
Not really a web so much as a series of maglev rings linked by guides, the Transit Web is separated from the platform by a barrier fence with automatic doors, which line up with Transit Capsule doors when a Capsule is in the station.  The Web rings glow faintly with the Magfield.

>x rings
Not really a web so much as a series of maglev rings linked by guides, the Transit Web is separated from the platform by a barrier fence with automatic doors, which line up with Transit Capsule doors when a Capsule is in the station.  The Web rings glow faintly with the Magfield.

>z
Time passes.

>wait for capsule
A light grows in the tunnel.  With a deep thrumming and the whoosh of displaced air, the Transit Capsule slides smoothly into Green Residential Platform and comes to a stop, hovering in the Web.  The doors slide open and a few commuters enter and exit the capsule.
A few commuters get on and off the Transit capsule.

A police officer strolls through the area, giving you a suspicious look before moving on.

>x capsule
A fifty-person maglev Transit Capsule.  The front window is dark, indicating that the capsule is running on automatic.  The Magfield causes a slight bluish glow around the bottom of the capsule.  Its doors are precisely level with the platform.

>enter
You must supply a noun.

A few commuters get on and off the Transit capsule.

>enter capsule
You move into the Transit Capsule.

Transit Capsule
A fifty-person maglev Transit capsule.  You're standing, holding on to a strap.  Through the windows you can see the Green Residential Platform. Several riders share the Capsule with you.

There is a Public Surveillance Notice here.

A few riders get on and off the Transit capsule.

The capsule doors slide shut.  The humming noice increases in volume, and the capsule slides out of the station, gathering speed as it goes, and slides into the tunnel..

You hold onto your strap as the Capsule rapidly accelerates.

>l
Transit Capsule
A fifty-person maglev Transit capsule.  You're standing, holding on to a strap.  A deep hum resonates through your bones, indicating that the Vectorfield is active.  Outside the narrow windows, the tunnel is dark.  Occasional blurry streaks show lights flashing past the moving Capsule. Several riders share the Capsule with you.

There is a Public Surveillance Notice here.

>l riders
You see a worried delivery worker intent on their destination.

>l riders
You see a young student eating a snack.

>z
Time passes.

>z
Time passes.

Someone coughs.

>z
Time passes.

With a deep thrumming and the whoosh of displaced air, the Transit Capsule slides smoothly into Green Service Platform and comes to a stop, hovering in the Web.  The doors slide open and a few commuters enter and exit the capsule.

>exit
Green Service Platform
Green Service One's platform is underground.  It serves mostly city workers during the day.  There is an exit at the center of the platform which leads north through a set of closed automatic doors to a stairway leading up to the main station, just next to a large plaque with the name of the station on it.  The platform abuts the Transit web to the south, where a Transit capsule hovers impatiently in the web.  The capsule doors are open.

You can see a Transit Map here.

You can go north through the Green Service Station door (closed) from here.

There is a Public Surveillance Notice here.

A few commuters get on and off the Transit capsule.

A public address system reminds you to be alert and "if you see something, say something!"

>x map
A metal sign displaying a map of Green Line Transit:
        -------------
        |   Green   |
        |  Service  |
        -------------
          /        ^
         /          \
        v            \
 -----------    -------------
 | Reserve |    |   Green   |
 |  Bank   |    |Residential|
 -----------    -------------
       \              ^
        \            /
         v          /
         ------------
         |  Green   |
         |Commercial|
         ------------

>xyzzy
A hollow voice says, "Were you expecting a poof of orange smoke?"

>n
(first opening the Green Service Station door)

Green Service Station
Green Service is the local government services cluster.  The Transit station seems to reflect this, exhibiting a weary conformity - although you couldn't say exactly how.  A stairway leads down to the platform access doors, and a set of doorways lead north out onto Government Square.

You can go north and down through the Green Service Station door to Green Service Platform from here.

There is a Public Surveillance Notice here.

The automatic door slides closed.

>n
Government Square South
This is the southern half of Government Square.  Several benches and landscape features are scattered throughout the area.  A roadway approaches from the west, loops north around the square and continues to the east.  Groundcars move back and forth along the road, mixed with official vehicles such as police cars, ambulances and the ubiquitous slightly shabby black flitters used by government agencies.  The doors to Green Service Transit station are to the south.  Across the road to the east is Green Hospital's driveway.  The Hospital's main entrance is to the northeast.  The square continues to the north.  To the northwest, across the road on the other side, is the front steps of the local police station.

The Reserve Bank Spacescraper is visible in the distance, rising over the low skyline.

You can go north, northeast, northwest, south to Green Service Station, and east from here.

There is a Public Surveillance Notice here.

>n
Government Square North
The north half of Government Square is surrounded on three sides by roadway.  Groundcars trundle back and forth, and the occasional flitter whines down to or screams up from flitter pads out of sight atop the surrounding buildings.  The hospital driveway is to the southeast, across the road; the hospital entrance to the east and the police station to the west.  To the north is the steps to the Civil Center, the local government office building.

The Reserve Bank Spacescraper is visible in the distance, rising over the low skyline.

It seems a tourist has left behind a cheap disposable camera, which rests on the sidewalk here.

You can go north, south to Government Square South, southeast, east, and west from here.

There is a Public Surveillance Notice here.

>get camera
Taken.

>put camera in pack
You put the lost camera into the backpack.

>n
Civil Center Steps
These are the front steps of an impressive government building.  Civil servants hurry in and out through the security checkpoint, going about their business.

The Reserve Bank Spacescraper is visible in the distance, rising over the low skyline.

You can also see Ponyfriend Chunky and the civil servants here.

You can go south to Government Square North from here.

There is a Public Surveillance Notice here.

Ponyfriend tries to interest as passer-by in his theories of a mechanistic Deity. Unsuccessfully.

>x ponyfriend
(Ponyfriend Chunky)
Dressed in ragged clothing, this man is looking around himself nervously, trying not to meet anyone's eye.  He is holding a sign that reads "HELP ME COMPLETE MY MISSION GIVE WHAT YOU CAN."

Ponyfriend Chunky is carrying a pager and a begging sign.

>x pager
It looks like a pretty old-school radio pager.  It also looks like it isn't working; the display is fogged over, there are no lights on it, and one of the two buttons on the front is missing. There is a small sliding panel on the back.

>x sign
Reading "HELP ME COMPLETE MY MISSION GIVE WHAT YOU CAN," the sign appears to be written in shaky black marker on a piece of cardboard.

>take pager
That seems to belong to Ponyfriend Chunky.

>ponyfriend, give me your pager
Ponyfriend responds out of the corner of his mouth, looking away. "Oh, my pager, yes.  This is how They send me my mission briefings. Well, what I mean is, they page me and I call them to get the briefings, yes.  I'm sorry, I have to keep checking to make sure they haven't paged me.  I wishI wish I could talk to them directly, though.. ll,, wh"

Ponyfriend looks up sharply, muttering "Did you hear that?" and checks his pager.

>ponyfriend, give me the pager
Ponyfriend looks frightened and clutches the pager to his chest.  "No! You can't have it!  THEY gave it to me! How would I know They needed me if I gave it to you?"

Ponyfriend looks up sharply, muttering "Did you hear that?" and checks his pager.

>ponyfriend, tell me about your missions
Ponyfriend's face animates and he looks up at you. "My missions?  They'rewell(a suspicious look comes over his face) They're secret! You can't know!"

>give phone to ponyfriend
(Ponyfriend Chunky)
Ponyfriend clutches the cell phone and mumbles "This is so much better, now I can get my instructions directly rather than having to call them back!"  He stands there for a moment, then seems to come to a realization.  "In fact, they can call me!  I don't need this pager!" he says.

Ponyfriend Chunky gives the pager to you.

>open pager
You open the pager, revealing a receive chip.

>take receive
Taken.

>put pager in pack
You put the pager into the backpack.

There is the sound of sirens in the distance.

>put receive in fob
You put the receive chip into the car key.

>i
You are carrying:
  a tablet computer
  some solder
  a soldering iron
  a cotter pin
  a backpack (being worn, and open)
    a pager (open but empty)
    a lost camera
    a newspaper
    a post-it
    a safety limiter
    a lockblade knife
    a car key
      a receive chip
  a multitool
  a watch

>xyzzy
A hollow voice says, "Were you expecting a poof of orange smoke?"

>xyzzy
A hollow voice says, "Nice try.  Please hold still for the camera."

>put pin and tablet and solder and iron in pack
cotter pin: Done.
tablet computer: Done.
solder: Done.
soldering iron: Done.

>wear watch
You put on the watch.

Ponyfriend checks his cell phone, looking disappointed that no-one has called.

>look
Civil Center Steps
These are the front steps of an impressive government building.  Civil servants hurry in and out through the security checkpoint, going about their business.

The Reserve Bank Spacescraper is visible in the distance, rising over the low skyline.

You can also see Ponyfriend Chunky and the civil servants here.

You can go south to Government Square North from here.

There is a Public Surveillance Notice here.

>l civil servants
They're ignoring you and appear to be concentrating on their errands.

>s
Government Square North
The north half of Government Square is surrounded on three sides by roadway.  Groundcars trundle back and forth, and the occasional flitter whines down to or screams up from flitter pads out of sight atop the surrounding buildings.  The hospital driveway is to the southeast, across the road; the hospital entrance to the east and the police station to the west.  To the north is the steps to the Civil Center, the local government office building.

The Reserve Bank Spacescraper is visible in the distance, rising over the low skyline.

You can go north to Civil Center Steps, south to Government Square South, southeast, east, and west from here.

There is a Public Surveillance Notice here.

>w
Police Station Steps
These are the busy steps of the local police station.  To the east and southeast is Government Square, while the police station lies at the top to the west. Uniformed police and people in plain clothes are traversing the steps to exit and enter the building.

The Reserve Bank Spacescraper is visible in the distance, rising over the low skyline.

You can go southeast to Government Square South, east to Government Square North, and west from here.

There is a Public Surveillance Notice here.

>l police
They're ignoring you.  SInce that's your preference, you decide not to stare.

>w
Front Desk
This is the front desk of the police station. A harried sergeant is manning the desk, and is so busy he doesn't even have time to give you more than a brief scowl.  To the north is a security gate leading into the police station proper, and to the south is an open area with a sign reading "BOOKING."

You can see Sergeant Ramirez here.

You can go south and east to Police Station Steps from here.

There is a Public Surveillance Notice here.

>l sergeant
(Sergeant Ramirez)
Seated behind his desk, this grizzled uniformed policeman is clearly a veteran of many years" service.  He scowls at you, waiting for you to make his life more annoying.

>sergeant, tell me about ponyfriend
The sergeant shakes his head.  "That guy needs serious help.  I'd stay away from him if I was you."

>s
Booking
This area is used for processing prisonerser, excuse me, suspects, and as a waiting lounge.  There is a single hard bench, now empty, and a counter along the south wall with a stern poster on the wall above it.  One area has been kept clear and is a neutral pale blue, presumably to be used as a backdrop for photographing suspects.

You can see an ID camera here.

You can go north to the Front Desk from here.

There is a Public Surveillance Notice here.

>x camera
(the ID camera)
A battered but serviceable device, this is a high resolution holocamera used by the police for recording suspects" identities.  It can either record to a local server if one is available, or to a standard Memory chip placed in its memory slot. It is securely attached to the countertop with a security chain to prevent anyone from walking off with it.

>n
Front Desk
This is the front desk of the police station. A harried sergeant is manning the desk, and is so busy he doesn't even have time to give you more than a brief scowl.  To the north is a security gate leading into the police station proper, and to the south is an open area with a sign reading "BOOKING."

You can see Sergeant Ramirez here.

You can go south to Booking and east to Police Station Steps from here.

There is a Public Surveillance Notice here.

The door swings open and two officers come in, manhandling a suspect between them.  Ignoring their suspect's complaints, they pause briefly to check in with the desk before moving on into the police station.

>e
Police Station Steps
These are the busy steps of the local police station.  To the east and southeast is Government Square, while the police station lies at the top to the west. Uniformed police and people in plain clothes are traversing the steps to exit and enter the building.

The Reserve Bank Spacescraper is visible in the distance, rising over the low skyline.

You can go southeast to Government Square South, east to Government Square North, and west to the Front Desk from here.

There is a Public Surveillance Notice here.

>s
You can't go that way.

>se
Government Square South
This is the southern half of Government Square.  Several benches and landscape features are scattered throughout the area.  A roadway approaches from the west, loops north around the square and continues to the east.  Groundcars move back and forth along the road, mixed with official vehicles such as police cars, ambulances and the ubiquitous slightly shabby black flitters used by government agencies.  The doors to Green Service Transit station are to the south.  Across the road to the east is Green Hospital's driveway.  The Hospital's main entrance is to the northeast.  The square continues to the north.  To the northwest, across the road on the other side, is the front steps of the local police station.

The Reserve Bank Spacescraper is visible in the distance, rising over the low skyline.

You can go north to Government Square North, northeast, northwest to Police Station Steps, south to Green Service Station, and east from here.

There is a Public Surveillance Notice here.

A tiny surveillance camera you're sure you didn't see before swivels to follow you.

>s
Green Service Station
Green Service is the local government services cluster.  The Transit station seems to reflect this, exhibiting a weary conformity - although you couldn't say exactly how.  A stairway leads down to the platform access doors, and a set of doorways lead north out onto Government Square.

You can go north to Government Square South and down through the Green Service Station door (closed) to Green Service Platform from here.

There is a Public Surveillance Notice here.

>d
(first opening the Green Service Station door)

Green Service Platform
Green Service One's platform is underground.  It serves mostly city workers during the day.  There is an exit at the center of the platform which leads north through a set of closed automatic doors to a stairway leading up to the main station, just next to a large plaque with the name of the station on it.  The platform abuts the Transit web to the south, where a Transit capsule hovers impatiently in the web.  The capsule doors are open.

You can see a Transit Map here.

You can go north through the Green Service Station door to Green Service Station from here.

There is a Public Surveillance Notice here.

A few commuters get on and off the Transit capsule.

The automatic door slides closed.

>enter
You must supply a noun.

A few commuters get on and off the Transit capsule.

>enter capsule
You move into the Transit Capsule.

Transit Capsule
A fifty-person maglev Transit capsule.  You're standing, holding on to a strap.  Through the windows you can see the Green Service Platform. Several riders share the Capsule with you.

There is a Public Surveillance Notice here.

A few riders get on and off the Transit capsule.

The capsule doors slide shut.  The humming noice increases in volume, and the capsule slides out of the station, gathering speed as it goes, and slides into the tunnel..

You hold onto your strap as the Capsule rapidly accelerates.

>z
Time passes.

>z
Time passes.

With a deep thrumming and the whoosh of displaced air, the Transit Capsule slides smoothly into Reserve Bank Station and comes to a stop, hovering in the Web.  The doors slide open and a few commuters enter and exit the capsule.

>z
Time passes.

A few riders get on and off the Transit capsule.

>z
Time passes.

A few riders get on and off the Transit capsule.

>z
Time passes.

A few riders get on and off the Transit capsule.

The capsule doors slide shut.  The humming noice increases in volume, and the capsule slides out of the station, gathering speed as it goes, and slides into the tunnel..

You hold onto your strap as the Capsule rapidly accelerates.

>z
Time passes.

>z
Time passes.

With a deep thrumming and the whoosh of displaced air, the Transit Capsule slides smoothly into Green Commercial Platform and comes to a stop, hovering in the Web.  The doors slide open and a few commuters enter and exit the capsule.

>exit
Green Commercial Platform
Green Commercial One is one of the oldest stations on the Transit web.  Although it has been refurbished several times, its age still manages to show through the layers of tile and paint.  The platform opens out at the middle to a lobby area which is dominated by a row of automated doors to the south, which lead to stairways up to the main station.  The flow of commuters moves steadily through these doors.  The floor and walls are both extremely scuffed duramex nanotile, and the station name (Green Commercial One) is indicated on a large plaque set into the walls. The platform abuts the Transit web to the north, where a Transit capsule can be seen hovering.  The capsule doors are open.

You can see a Transit Map here.

You can go south through the Green Commercial Station door (closed) from here.

There is a Public Surveillance Notice here.

A few commuters get on and off the Transit capsule.

>s
(first opening the Green Commercial Station door)

Green Commercial Station
Green Commercial One's Transit station usually does most of its business around the rush hours, as Green Residental commuters stop off to take care of errands.  The station is relatively small, but well kept up - the Green Commercial Business Improvement District organization sees to that.  Open doorways lead south to Green Commercial One proper, and a stairway leads down to the doors to the Transit platform.

You can go south and down through the Green Commercial Station door to Green Commercial Platform from here.

There is a Public Surveillance Notice here.

The automatic door slides closed.

>s
Green Commercial Plaza North
Green Commercial One is built around a plaza, and this is its northern end.  No vehicles are permitted within the public areas of Green Commercial One, so the entire area is pedestrian-only.  To the north are the doorways to the Green Commercial Station.  To the east is RoughIt.  To the west is a storefront bank with an ATM.  The plaza continues to the south.

The Reserve Bank Spacescraper is visible in the distance, rising over the low skyline.

You can also see a trash can (closed) here.

You can go north to Green Commercial Station, south, southeast, southwest, east, and west from here.

There is a Public Surveillance Notice here.

>s
Green Commercial Plaza Center
This is the center of the Green Commercial Plaza.  There is a fountain here with a bench facing it.  The plaza continues to the north and south; to the east is a bar called (ironically, you hope) the Proletariat.  To the west is a Bistro Paris cafe.

The Reserve Bank Spacescraper is visible in the distance, rising over the low skyline.

You can also see a trash can (closed) here.

You can go north to Green Commercial Plaza North, northeast, northwest, south, southeast, east, and west from here.

There is a Public Surveillance Notice here.

>look in trashcan
You open the trash can, revealing a drop message and some rubbish.

In the trash can are a drop message and some rubbish.

>get drop message
You unfold the message as you take it.

>read drop message
A small piece of flash paper  which contains the following message: "IF THIS MESSAGE RETRIEVED ATTACK PAYLOAD IS FUNCTIONAL.  YOUR MK RECORD NOW DISTRIBUTED TO ALL SECURITY ELEMENTS.  TO EFFECT ESCAPE AND COMPLETE MISSION, USE PAYLOAD TO DISRUPT ANY BLOCKING HOMELAND SECURITY PERSONNEL.  FOR LARGE CROWDS, A MINIMUM OF THREE SEQUENTIAL ATTACKS WILL BE REQUIRED TO DISRUPT ENOUGH OPERATIVES TO PERMIT ESCAPE.  DROP SHUTTLE WILL MAKE PICKUP ONCE YOU REACH THE RESERVE BANK SPACESCRAPER SEMIBALLISTIC ROOF PADS.  ACCESS TO PADS ONLY AVAILABLE VIA SPECIAL LIFT TUBE IN MAIN ATRIUM LEVEL."

>drop message
You trigger the flash paper and drop the message.  There is a quick flash of flame, and it vanishes utterly!

>s
Green Commercial Plaza South
The southern end of the Green Commercial Plaza, which continues to the north.  To the east is Accessorize, a fashion store, and to the west is Garb-oh, a trendy clothing shop.  The south end of the mall is closed off by an elaborate landscaping installation of trees and shrubs, presumably to hide a relatively ugly building behind it.

The Reserve Bank Spacescraper is visible in the distance, rising over the low skyline.

You can also see a trash can (closed) here.

You can go north to Green Commercial Plaza Center, northeast, northwest, east, and west through the Garb-oh door (closed) from here.

There is a Public Surveillance Notice here.

>w
(first opening the Garb-oh door)

Garb-oh
Garb-oh! is a trendy clothing shop.  Images of the shop's icon Greta Garbo abound, each dressed in the clothing item offered on the rack below it.  Jackets, scarves, bandannas, trousers, shirts and more are on inviting display.

On the racks are a blue jacket, a red jacket, a white shirt, a green shirt, a blue pair of pants, and a brown pair of pants.

The sales counter runs along the north side of the store.

You can also see the shopkeeper and the shopper here.

You can go east through the Garb-oh door to Green Commercial Plaza South from here.

There is a Public Surveillance Notice here.

The automatic door slides closed.

>take brown pants
Taken.

>put brown pants in shoulder bag
You stealthily slide the brown pair of pants into the shoulder bag!

The shopper puts down a last item of clothing and drifts towards the door.  As she reaches it, however, the antitheft alarm blares and a strobe light begins to flash!  She stops, frozen in surprise, as the shopkeeper rushes over and grabs her.  A few seconds later, two policemen enter the shop.  The shopkeeper, shopper and police all begin shouting at the same time.

>go behind counter
You move around behind the sales counter.

Garb-oh (in the sales counter)
Garb-oh! is a trendy clothing shop.  Images of the shop's icon Greta Garbo abound, each dressed in the clothing item offered on the rack below it.  Jackets, scarves, bandannas, trousers, shirts and more are on inviting display.

On the racks are a blue jacket, a red jacket, a white shirt, a green shirt, and a blue pair of pants.

You can also see a Patrolman, Officer Prescott, the shopkeeper, and the shopper here.

There is a wide drawer below the counter level.

You can go east through the Garb-oh door (closed) to Green Commercial Plaza South from here.

There is a Public Surveillance Notice here.

>open drawer
You open the sales drawer, revealing a tag remover.

>get tag remover
Taken.

>s
You move out from behind the sales counter.

Garb-oh
Garb-oh! is a trendy clothing shop.  Images of the shop's icon Greta Garbo abound, each dressed in the clothing item offered on the rack below it.  Jackets, scarves, bandannas, trousers, shirts and more are on inviting display.

On the racks are a blue jacket, a red jacket, a white shirt, a green shirt, and a blue pair of pants.

The sales counter runs along the north side of the store.

You can also see a Patrolman, Officer Prescott, the shopkeeper, and the shopper here.

You can go east through the Garb-oh door (closed) to Green Commercial Plaza South from here.

There is a Public Surveillance Notice here.

>i
You are carrying:
  a tag remover
  a backpack (being worn, and open)
    a soldering iron
    some solder
    a tablet computer
    a cotter pin
    a pager (open but empty)
    a lost camera
    a newspaper
    a post-it
    a safety limiter
    a lockblade knife
    a car key
      a receive chip
  a multitool
  a watch (being worn)

>e
(first opening the Garb-oh door)

Green Commercial Plaza South
The southern end of the Green Commercial Plaza, which continues to the north.  To the east is Accessorize, a fashion store, and to the west is Garb-oh, a trendy clothing shop.  The south end of the mall is closed off by an elaborate landscaping installation of trees and shrubs, presumably to hide a relatively ugly building behind it.

The Reserve Bank Spacescraper is visible in the distance, rising over the low skyline.

You can also see a trash can (closed) here.

You can go north to Green Commercial Plaza Center, northeast, northwest, east, and west through the Garb-oh door to Garb-oh from here.

There is a Public Surveillance Notice here.

The automatic door slides closed.

>n
Green Commercial Plaza Center
This is the center of the Green Commercial Plaza.  There is a fountain here with a bench facing it.  The plaza continues to the north and south; to the east is a bar called (ironically, you hope) the Proletariat.  To the west is a Bistro Paris cafe.

The Reserve Bank Spacescraper is visible in the distance, rising over the low skyline.

You can also see a trash can (in which is some rubbish) here.

You can go north to Green Commercial Plaza North, northeast, northwest, south to Green Commercial Plaza South, southeast, east, and west from here.

There is a Public Surveillance Notice here.

>n
Green Commercial Plaza North
Green Commercial One is built around a plaza, and this is its northern end.  No vehicles are permitted within the public areas of Green Commercial One, so the entire area is pedestrian-only.  To the north are the doorways to the Green Commercial Station.  To the east is RoughIt.  To the west is a storefront bank with an ATM.  The plaza continues to the south.

The Reserve Bank Spacescraper is visible in the distance, rising over the low skyline.

You can also see a trash can (closed) here.

You can go north to Green Commercial Station, south to Green Commercial Plaza Center, southeast, southwest, east, and west from here.

There is a Public Surveillance Notice here.

>e
RoughIt
This diorama of a shop is the City's largest camping and outdoors supplier.  Although the store is full of equipment, it's just props, firmly secured - because everything is only available via an automated vending system, provided you don't mind your purchases being relentlessly catalogued by the Department of Homeland Security.  You stopped shopping here after they told you you couldn't buy a coffee without using biometric authentication.  One item catches your eye, though - there is a metal thermos sitting out of place atop the vending system.  Someone must have forgotten it.

On the vending system is a thermos (closed).

You can go southwest to Green Commercial Plaza Center and west to Green Commercial Plaza North from here.

There is a Public Surveillance Notice here.

>take thermos
Taken.

>sw
Green Commercial Plaza Center
This is the center of the Green Commercial Plaza.  There is a fountain here with a bench facing it.  The plaza continues to the north and south; to the east is a bar called (ironically, you hope) the Proletariat.  To the west is a Bistro Paris cafe.

The Reserve Bank Spacescraper is visible in the distance, rising over the low skyline.

You can also see a trash can (in which is some rubbish) here.

You can go north to Green Commercial Plaza North, northeast to RoughIt, northwest, south to Green Commercial Plaza South, southeast, east, and west from here.

There is a Public Surveillance Notice here.

>s
Green Commercial Plaza South
The southern end of the Green Commercial Plaza, which continues to the north.  To the east is Accessorize, a fashion store, and to the west is Garb-oh, a trendy clothing shop.  The south end of the mall is closed off by an elaborate landscaping installation of trees and shrubs, presumably to hide a relatively ugly building behind it.

The Reserve Bank Spacescraper is visible in the distance, rising over the low skyline.

You can also see a trash can (closed) here.

You can go north to Green Commercial Plaza Center, northeast, northwest, east, and west through the Garb-oh door (closed) to Garb-oh from here.

There is a Public Surveillance Notice here.

You see a small red light in the corner of your vision which vanishes as you turn to look at it.

>w
(first opening the Garb-oh door)

Garb-oh
Garb-oh! is a trendy clothing shop.  Images of the shop's icon Greta Garbo abound, each dressed in the clothing item offered on the rack below it.  Jackets, scarves, bandannas, trousers, shirts and more are on inviting display.

On the racks are a blue jacket, a red jacket, a white shirt, a green shirt, and a blue pair of pants.

The sales counter runs along the north side of the store.

You can also see the shopkeeper here.

You can go east through the Garb-oh door to Green Commercial Plaza South from here.

There is a Public Surveillance Notice here.

The automatic door slides closed.

>take blue jacket
Taken.

>remove blue jacket's antitheft tag with tag remover
You deftly remove the tag with the tag remover.

A small group of people enter the store, look around, look at each other and file back out.

>open thermos
You open the thermos.

>put tag in thermos
Which do you mean, the blue jacket's antitheft tag, the tag remover, the red jacket's antitheft tag, the white shirt's antitheft tag, the green shirt's antitheft tag, or the blue pair of pants's antitheft tag?

>put blue jacket's antitheft tag in thermos
You put the blue jacket's antitheft tag into the thermos.

>put blue jacket in pack
You put the blue jacket into the backpack.

>take red jacket
Taken.

>remove red jacket's tag with tag remover
You deftly remove the tag with the tag remover.

>put red jacket's tag in thermos
You put the red jacket's antitheft tag into the thermos.

A small group of people enter the store, look around, look at each other and file back out.

>put red jacket on racks
You put the red jacket on the racks.

A small group of people enter the store, look around, look at each other and file back out.

>get green shirt
Taken.

>remove green shirt's tag with tag remover
You deftly remove the tag with the tag remover.

>put green shirt on racks
You put the green shirt on the racks.

A small group of people enter the store, look around, look at each other and file back out.

>put green shirt's tag in thermos
You put the green shirt's antitheft tag into the thermos.

>take white shirt
Taken.

>remove white shirt's tag with tag remover
You deftly remove the tag with the tag remover.

>put white shirt on racks
You put the white shirt on the racks.

>put white shirt's tag in thermos
You put the white shirt's antitheft tag into the thermos.

The shopkeeper wanders past you and gives you a suspicious look.

>close thermos
You close the thermos.

>put thermos in pack
You put the thermos into the backpack.

>e
(first opening the Garb-oh door)

Green Commercial Plaza South
The southern end of the Green Commercial Plaza, which continues to the north.  To the east is Accessorize, a fashion store, and to the west is Garb-oh, a trendy clothing shop.  The south end of the mall is closed off by an elaborate landscaping installation of trees and shrubs, presumably to hide a relatively ugly building behind it.

The Reserve Bank Spacescraper is visible in the distance, rising over the low skyline.

You can also see a trash can (closed) here.

You can go north to Green Commercial Plaza Center, northeast, northwest, east, and west through the Garb-oh door to Garb-oh from here.

There is a Public Surveillance Notice here.

The automatic door slides closed.

A police flitter spirals slowly down out of the sky, beacons strobing and warning tones blaring.  It comes to a rest in the clear area in the middle of the plaza and powers down.  Officer Prescott gets out, closes the door and ambles off towards the Bistro nearby, probably to get a coffee.

>n
Green Commercial Plaza Center
This is the center of the Green Commercial Plaza.  There is a fountain here with a bench facing it.  The plaza continues to the north and south; to the east is a bar called (ironically, you hope) the Proletariat.  To the west is a Bistro Paris cafe.

The Reserve Bank Spacescraper is visible in the distance, rising over the low skyline.

You can also see a trash can (in which is some rubbish) here.

You can go north to Green Commercial Plaza North, northeast to RoughIt, northwest, south to Green Commercial Plaza South, southeast, east, and west from here.

There is a Public Surveillance Notice here.

>n
Green Commercial Plaza North
Green Commercial One is built around a plaza, and this is its northern end.  No vehicles are permitted within the public areas of Green Commercial One, so the entire area is pedestrian-only.  To the north are the doorways to the Green Commercial Station.  To the east is RoughIt.  To the west is a storefront bank with an ATM.  The plaza continues to the south.

The Reserve Bank Spacescraper is visible in the distance, rising over the low skyline.

You can also see a trash can (closed) here.

You can go north to Green Commercial Station, south to Green Commercial Plaza Center, southeast, southwest, east to RoughIt, and west from here.

There is a Public Surveillance Notice here.

>n
Green Commercial Station
Green Commercial One's Transit station usually does most of its business around the rush hours, as Green Residental commuters stop off to take care of errands.  The station is relatively small, but well kept up - the Green Commercial Business Improvement District organization sees to that.  Open doorways lead south to Green Commercial One proper, and a stairway leads down to the doors to the Transit platform.

You can go south to Green Commercial Plaza North and down through the Green Commercial Station door (closed) to Green Commercial Platform from here.

There is a Public Surveillance Notice here.

>d
(first opening the Green Commercial Station door)

Green Commercial Platform
Green Commercial One is one of the oldest stations on the Transit web.  Although it has been refurbished several times, its age still manages to show through the layers of tile and paint.  The platform opens out at the middle to a lobby area which is dominated by a row of automated doors to the south, which lead to stairways up to the main station.  The flow of commuters moves steadily through these doors.  The floor and walls are both extremely scuffed duramex nanotile, and the station name (Green Commercial One) is indicated on a large plaque set into the walls. The platform abuts the Transit web to the north, now empty.

You can see a Transit Map here.

You can go south through the Green Commercial Station door to Green Commercial Station from here.

There is a Public Surveillance Notice here.

The automatic door slides closed.

>wait for capsule
You see a small mouse scurry along the Transit Web and vanish back into the tunnels.

A light grows in the tunnel.  With a deep thrumming and the whoosh of displaced air, the Transit Capsule slides smoothly into Green Commercial Platform and comes to a stop, hovering in the Web.  The doors slide open and a few commuters enter and exit the capsule.
A few commuters get on and off the Transit capsule.

>enter capsule
You move into the Transit Capsule.

Transit Capsule
A fifty-person maglev Transit capsule.  You're standing, holding on to a strap.  Through the windows you can see the Green Commercial Platform. Several riders share the Capsule with you.

There is a Public Surveillance Notice here.

A few riders get on and off the Transit capsule.

>wait for green residential
(Green Residential Platform)
A few riders get on and off the Transit capsule.

The capsule doors slide shut.  The humming noice increases in volume, and the capsule slides out of the station, gathering speed as it goes, and slides into the tunnel..

You hold onto your strap as the Capsule rapidly accelerates.

With a deep thrumming and the whoosh of displaced air, the Transit Capsule slides smoothly into Green Residential Platform and comes to a stop, hovering in the Web.  The doors slide open and a few commuters enter and exit the capsule.
A few riders get on and off the Transit capsule.

>exit
Green Residential Platform
Green Residential's platform serves mostly residential commuters.  There is an exit at the center of the platform which leads east through a set of closed automatic doors to a stairway leading up to the main station, just next to a large plaque with the name of the station on it.  The platform abuts the Transit web to the west, where a Transit capsule hovers impatiently.  The capsule doors are open.

You can see a Transit Map here.

You can go east through the Green Residential Station door (closed) to Green Residential Station from here.

There is a Public Surveillance Notice here.

A few commuters get on and off the Transit capsule.

A public address system reminds you to be alert and "if you see something, say something!"

>e
(first opening the Green Residential Station door)
The Eye Scanner laser delicately probes your iris, and the doors slide smoothly open.

Green Residential Station
This is a utilitarian shelter intended mostly to keep the rain out of the Transit System.  A stairway leads down to the autodoor leading to the Transit platform and an exit leads east to the street.

You can go east to Primrose & Station and down through the Green Residential Station door to Green Residential Platform from here.

There is a Public Surveillance Notice here.

The automatic door slides closed.

>e
Primrose & Station
This staid neighborhood intersection of Primrose Lane and Cedar Street fronts the local Transit station, Green Residential.  The station entrance is to the west.  Primrose Lane continues to the south.

The Reserve Bank Spacescraper is visible in the distance, rising over the low skyline.

You can go north to Green Residential Park, south to South Primrose Lane, and west to Green Residential Station from here.

There is a Public Surveillance Notice here.

>s
South Primrose Lane
Primrose Lane continues to the north.  To the south is a boarded-up empty house; sumac plants can be seen peeking over the top of the dilapidated fencing.  The fence has a plastic tarp strung behind it which prevents you from seeing much of the house.  To the west is a single-family home with a large warning sign and an enormous dog on the front lawn.  To the east is a three-family residence's front path.

The Reserve Bank Spacescraper is visible in the distance, rising over the low skyline.

You can go north to Primrose & Station and east to Front Path from here.

There is a Public Surveillance Notice here.

>x fence
A combination of cyclone fence - interleaved wire - with plastic sheeting hung behind, it blocks your view.  You can hear rustling and low murmuring from behind it, as of people moving around and talking furtively.

>cut fence with tag remover
You carefully cut through several strands of the fence until you have an opening big enough to slip through and slice a rent in the backing plastic.

>s
Drug Market
Standing just south of the fence, you see an abandoned house on the south side of the lot. The front yard is a mess of trash and litter.  A few people are hanging around the closed front door.  They are looking at you with unfriendly stares. You're fairly sure you can see small vials and cash changing hands in the shadows.

The Reserve Bank Spacescraper is visible in the distance, rising over the low skyline.

You can go north to South Primrose Lane and south from here.

>s
Your path is blocked by two hostile-looking types.  One is clearly holding a gun behind his back.  Deciding you're not that curious, you retreat.

>n
South Primrose Lane
Primrose Lane continues to the north.  To the south is a boarded-up empty house; sumac plants can be seen peeking over the top of the dilapidated fencing.  The fence has a plastic tarp strung behind it which prevents you from seeing much of the house.  To the west is a single-family home with a large warning sign and an enormous dog on the front lawn.  To the east is a three-family residence's front path.

The Reserve Bank Spacescraper is visible in the distance, rising over the low skyline.

You can go north to Primrose & Station, south to Drug Market, and east to Front Path from here.

There is a Public Surveillance Notice here.

>n
Primrose & Station
This staid neighborhood intersection of Primrose Lane and Cedar Street fronts the local Transit station, Green Residential.  The station entrance is to the west.  Primrose Lane continues to the south.

The Reserve Bank Spacescraper is visible in the distance, rising over the low skyline.

You can go north to Green Residential Park, south to South Primrose Lane, and west to Green Residential Station from here.

There is a Public Surveillance Notice here.

>w
Green Residential Station
This is a utilitarian shelter intended mostly to keep the rain out of the Transit System.  A stairway leads down to the autodoor leading to the Transit platform and an exit leads east to the street.

You can go east to Primrose & Station and down through the Green Residential Station door (closed) to Green Residential Platform from here.

There is a Public Surveillance Notice here.

>d
(first opening the Green Residential Station door)
The Door Scanner scans your iris to determine your identity.  The Transit Security and Accounting Subroutine determines that you have a legitimate account with the Transit system, and the doors slide smoothly open.

Green Residential Platform
Green Residential's platform serves mostly residential commuters.  There is an exit at the center of the platform which leads east through a set of closed automatic doors to a stairway leading up to the main station, just next to a large plaque with the name of the station on it.  The platform abuts the Transit web to the west, now empty.

You can see a Transit Map here.

You can go east through the Green Residential Station door to Green Residential Station from here.

There is a Public Surveillance Notice here.

The automatic door slides closed.

>wait for capsule
A commuter walks by.

A tiny surveillance camera you're sure you didn't see before swivels to follow you.

A light grows in the tunnel.  With a deep thrumming and the whoosh of displaced air, the Transit Capsule slides smoothly into Green Residential Platform and comes to a stop, hovering in the Web.  The doors slide open and a few commuters enter and exit the capsule.
A few commuters get on and off the Transit capsule.

>enter capsule
You move into the Transit Capsule.

Transit Capsule
A fifty-person maglev Transit capsule.  You're standing, holding on to a strap.  Through the windows you can see the Green Residential Platform. Several riders share the Capsule with you.

There is a Public Surveillance Notice here.

A few riders get on and off the Transit capsule.

>wait for green service
(Green Service Platform)
A few riders get on and off the Transit capsule.

The capsule doors slide shut.  The humming noice increases in volume, and the capsule slides out of the station, gathering speed as it goes, and slides into the tunnel..

You hold onto your strap as the Capsule rapidly accelerates.

A shabbily-dressed man wanders up to you.  He appears to be about to ask you for something, but then he catches a look at your eyes and instead wanders away again.

With a deep thrumming and the whoosh of displaced air, the Transit Capsule slides smoothly into Green Service Platform and comes to a stop, hovering in the Web.  The doors slide open and a few commuters enter and exit the capsule.
A few riders get on and off the Transit capsule.

>exit
Green Service Platform
Green Service One's platform is underground.  It serves mostly city workers during the day.  There is an exit at the center of the platform which leads north through a set of closed automatic doors to a stairway leading up to the main station, just next to a large plaque with the name of the station on it.  The platform abuts the Transit web to the south, where a Transit capsule hovers impatiently in the web.  The capsule doors are open.

You can see a Transit Map here.

You can go north through the Green Service Station door (closed) to Green Service Station from here.

There is a Public Surveillance Notice here.

A few commuters get on and off the Transit capsule.

>n
(first opening the Green Service Station door)

Green Service Station
Green Service is the local government services cluster.  The Transit station seems to reflect this, exhibiting a weary conformity - although you couldn't say exactly how.  A stairway leads down to the platform access doors, and a set of doorways lead north out onto Government Square.

You can go north to Government Square South and down through the Green Service Station door to Green Service Platform from here.

There is a Public Surveillance Notice here.

The automatic door slides closed.

>n
Government Square South
This is the southern half of Government Square.  Several benches and landscape features are scattered throughout the area.  A roadway approaches from the west, loops north around the square and continues to the east.  Groundcars move back and forth along the road, mixed with official vehicles such as police cars, ambulances and the ubiquitous slightly shabby black flitters used by government agencies.  The doors to Green Service Transit station are to the south.  Across the road to the east is Green Hospital's driveway.  The Hospital's main entrance is to the northeast.  The square continues to the north.  To the northwest, across the road on the other side, is the front steps of the local police station.

The Reserve Bank Spacescraper is visible in the distance, rising over the low skyline.

You can go north to Government Square North, northeast, northwest to Police Station Steps, south to Green Service Station, and east from here.

There is a Public Surveillance Notice here.

A tiny surveillance camera you're sure you didn't see before swivels to follow you.

>nw
Police Station Steps
These are the busy steps of the local police station.  To the east and southeast is Government Square, while the police station lies at the top to the west. Uniformed police and people in plain clothes are traversing the steps to exit and enter the building.

The Reserve Bank Spacescraper is visible in the distance, rising over the low skyline.

You can go southeast to Government Square South, east to Government Square North, and west to the Front Desk from here.

There is a Public Surveillance Notice here.

>w
Front Desk
This is the front desk of the police station. A harried sergeant is manning the desk, and is so busy he doesn't even have time to give you more than a brief scowl.  To the north is a security gate leading into the police station proper, and to the south is an open area with a sign reading "BOOKING."

You can see Sergeant Ramirez here.

You can go south to Booking and east to Police Station Steps from here.

There is a Public Surveillance Notice here.

The telephone rings.  Sergeant Ramirez answers gruffly, speaks a few words and hangs up.

>s
Booking
This area is used for processing prisonerser, excuse me, suspects, and as a waiting lounge.  There is a single hard bench, now empty, and a counter along the south wall with a stern poster on the wall above it.  One area has been kept clear and is a neutral pale blue, presumably to be used as a backdrop for photographing suspects.

You can see an ID camera here.

You can go north to the Front Desk from here.

There is a Public Surveillance Notice here.

>cut chain with tag remover
Looking around to check for watchers, you place your back to the surveillance camera and snip through the ID camera security chain with the tag remover!

>take id camera
Taken.

>put id camera in pack
You put the ID camera into the backpack.

>n
Front Desk
This is the front desk of the police station. A harried sergeant is manning the desk, and is so busy he doesn't even have time to give you more than a brief scowl.  To the north is a security gate leading into the police station proper, and to the south is an open area with a sign reading "BOOKING."

You can see Sergeant Ramirez here.

You can go south to Booking and east to Police Station Steps from here.

There is a Public Surveillance Notice here.

>sergeant, tell me about drugs
The sergeant suddenly becomes animated, looking directly at you.  "What?" he barks.  "Drugs?  Where?"  You explain to him that you had seen shifty characters and drugs in the Drug Market.  He picks up the phone and has an animated conversation with someone on the other end, the word "drugs" and "extreme" and "losers" coming up with frequency.  He has lost interest in you.

The telephone rings.  Sergeant Ramirez answers gruffly, speaks a few words and hangs up.

>e
Police Station Steps
These are the busy steps of the local police station.  To the east and southeast is Government Square, while the police station lies at the top to the west. Uniformed police and people in plain clothes are traversing the steps to exit and enter the building.

The Reserve Bank Spacescraper is visible in the distance, rising over the low skyline.

You can go southeast to Government Square South, east to Government Square North, and west to the Front Desk from here.

There is a Public Surveillance Notice here.

>se
Government Square South
This is the southern half of Government Square.  Several benches and landscape features are scattered throughout the area.  A roadway approaches from the west, loops north around the square and continues to the east.  Groundcars move back and forth along the road, mixed with official vehicles such as police cars, ambulances and the ubiquitous slightly shabby black flitters used by government agencies.  The doors to Green Service Transit station are to the south.  Across the road to the east is Green Hospital's driveway.  The Hospital's main entrance is to the northeast.  The square continues to the north.  To the northwest, across the road on the other side, is the front steps of the local police station.

The Reserve Bank Spacescraper is visible in the distance, rising over the low skyline.

You can go north to Government Square North, northeast, northwest to Police Station Steps, south to Green Service Station, and east from here.

There is a Public Surveillance Notice here.

>s
Green Service Station
Green Service is the local government services cluster.  The Transit station seems to reflect this, exhibiting a weary conformity - although you couldn't say exactly how.  A stairway leads down to the platform access doors, and a set of doorways lead north out onto Government Square.

You can go north to Government Square South and down through the Green Service Station door (closed) to Green Service Platform from here.

There is a Public Surveillance Notice here.

>d
(first opening the Green Service Station door)

Green Service Platform
Green Service One's platform is underground.  It serves mostly city workers during the day.  There is an exit at the center of the platform which leads north through a set of closed automatic doors to a stairway leading up to the main station, just next to a large plaque with the name of the station on it.  The platform abuts the Transit web to the south, now empty.

You can see a Transit Map here.

You can go north through the Green Service Station door to Green Service Station from here.

There is a Public Surveillance Notice here.

A public address system reminds you to be alert and "if you see something, say something!"

The automatic door slides closed.

>wait for capsule
A commuter walks by.

A light grows in the tunnel.  With a deep thrumming and the whoosh of displaced air, the Transit Capsule slides smoothly into Green Service Platform and comes to a stop, hovering in the Web.  The doors slide open and a few commuters enter and exit the capsule.
A few commuters get on and off the Transit capsule.

>enter capsule
You move into the Transit Capsule.

Transit Capsule
A fifty-person maglev Transit capsule.  You're standing, holding on to a strap.  Through the windows you can see the Green Service Platform. Several riders share the Capsule with you.

There is a Public Surveillance Notice here.

A few riders get on and off the Transit capsule.

>wait for commercial
(Green Commercial Platform)
A few riders get on and off the Transit capsule.

The capsule doors slide shut.  The humming noice increases in volume, and the capsule slides out of the station, gathering speed as it goes, and slides into the tunnel..

You hold onto your strap as the Capsule rapidly accelerates.

A nearby commuter's handheld begins beeping loudly.  She hurriedly shuts it off.

With a deep thrumming and the whoosh of displaced air, the Transit Capsule slides smoothly into Reserve Bank Station and comes to a stop, hovering in the Web.  The doors slide open and a few commuters enter and exit the capsule.
A few riders get on and off the Transit capsule.

A few riders get on and off the Transit capsule.

A few riders get on and off the Transit capsule.

The capsule doors slide shut.  The humming noice increases in volume, and the capsule slides out of the station, gathering speed as it goes, and slides into the tunnel..

You hold onto your strap as the Capsule rapidly accelerates.

A man nearby yawns.

With a deep thrumming and the whoosh of displaced air, the Transit Capsule slides smoothly into Green Commercial Platform and comes to a stop, hovering in the Web.  The doors slide open and a few commuters enter and exit the capsule.
A few riders get on and off the Transit capsule.

>exit
Green Commercial Platform
Green Commercial One is one of the oldest stations on the Transit web.  Although it has been refurbished several times, its age still manages to show through the layers of tile and paint.  The platform opens out at the middle to a lobby area which is dominated by a row of automated doors to the south, which lead to stairways up to the main station.  The flow of commuters moves steadily through these doors.  The floor and walls are both extremely scuffed duramex nanotile, and the station name (Green Commercial One) is indicated on a large plaque set into the walls. The platform abuts the Transit web to the north, where a Transit capsule can be seen hovering.  The capsule doors are open.

You can see a Transit Map here.

You can go south through the Green Commercial Station door (closed) to Green Commercial Station from here.

There is a Public Surveillance Notice here.

A few commuters get on and off the Transit capsule.

>s
(first opening the Green Commercial Station door)

Green Commercial Station
Green Commercial One's Transit station usually does most of its business around the rush hours, as Green Residental commuters stop off to take care of errands.  The station is relatively small, but well kept up - the Green Commercial Business Improvement District organization sees to that.  Open doorways lead south to Green Commercial One proper, and a stairway leads down to the doors to the Transit platform.

You can go south to Green Commercial Plaza North and down through the Green Commercial Station door to Green Commercial Platform from here.

There is a Public Surveillance Notice here.

The automatic door slides closed.

>s
Green Commercial Plaza North
Green Commercial One is built around a plaza, and this is its northern end.  No vehicles are permitted within the public areas of Green Commercial One, so the entire area is pedestrian-only.  To the north are the doorways to the Green Commercial Station.  To the east is RoughIt.  To the west is a storefront bank with an ATM.  The plaza continues to the south.

The Reserve Bank Spacescraper is visible in the distance, rising over the low skyline.

You can also see a trash can (closed) here.

You can go north to Green Commercial Station, south to Green Commercial Plaza Center, southeast, southwest, east to RoughIt, and west from here.

There is a Public Surveillance Notice here.

>s
Green Commercial Plaza Center
This is the center of the Green Commercial Plaza.  There is a fountain here with a bench facing it.  The plaza continues to the north and south; to the east is a bar called (ironically, you hope) the Proletariat.  To the west is a Bistro Paris cafe.

The Reserve Bank Spacescraper is visible in the distance, rising over the low skyline.

You can also see a trash can (in which is some rubbish) here.

You can go north to Green Commercial Plaza North, northeast to RoughIt, northwest, south to Green Commercial Plaza South, southeast, east, and west from here.

There is a Public Surveillance Notice here.

>w
Green Commercial Bistro Paris
This is a branch of the popular lunch and coffee shop Bistro Paris.  There are a few tables near the front.  A restroom is to the west.  On the north wall, opposite the counter, is a collection of Paris-themed prints.  In the center is a large holoportrait of the chain's owner, Zuzu, and a sign claiming that the Bistro Paris has restaurants here, in the Reserve Bank Spacescraper, and in London.  A server behind the counter is waiting on several customers.

You can see Officer Prescott and a trash can (closed) here.

You can go northeast to Green Commercial Plaza North, southeast to Green Commercial Plaza South, east to Green Commercial Plaza Center, and west from here.

There is a Public Surveillance Notice here.

A tiny surveillance camera you're sure you didn't see before swivels to follow you.

>e
Green Commercial Plaza Center
This is the center of the Green Commercial Plaza.  There is a fountain here with a bench facing it.  The plaza continues to the north and south; to the east is a bar called (ironically, you hope) the Proletariat.  To the west is a Bistro Paris cafe.

The Reserve Bank Spacescraper is visible in the distance, rising over the low skyline.

You can also see a trash can (in which is some rubbish) here.

You can go north to Green Commercial Plaza North, northeast to RoughIt, northwest, south to Green Commercial Plaza South, southeast, east, and west to Green Commercial Bistro Paris from here.

There is a Public Surveillance Notice here.

>e
The Proletariat Bar
The Proletariat is a local bar (not a pub).  It's just far enough above a "dive" to be allowed zoning here, but steadfastedly refuses to cater to upscale tastes.  You like it.  Restrooms are to the east; the bar runs along the north side with a stolid bartender behind it and a jukebox sits against the back wall.  A few hardy drinkers sit here, communing with their spirits.  In a nod to the place's name, a Public Surveillance Notice covered with stickers and graffiti tags has been framed above the bar.

You can see a Bartender and a man here.

You can go northwest to Green Commercial Plaza North, southwest to Green Commercial Plaza South, east, and west to Green Commercial Plaza Center from here.

There is a Public Surveillance Notice here.

>e
Proletariat Restroom
The one-holer restroom at the Proletariat is cleaner than you might think, although that may be due to the fact that it is midweek.  A scratched mirror over the sink has been covered with marker graffiti.

You can see a trash can (closed) here.

You can go west to The Proletariat Bar from here.

>open thermos
You open the thermos, revealing a white shirt's antitheft tag, a green shirt's antitheft tag, a red jacket's antitheft tag, and a blue jacket's antitheft tag.

>take blue jacket's tag
Taken.

>cut blue jacket's tag with knife
Taken.

You carefully cut open the tag with your knife and peel back the plastic to reveal a blank memory chip.

>take memory
Taken.

>drop blue jacket's tag
Dropped.

>cut green shirt's tag with knife
Taken.

You carefully cut open the tag with your knife and peel back the plastic to reveal a blank memory chip.

>take memory
Taken.

>drop green shirt's tag
Dropped.

>cut white shirt's tag with knife
Taken.

You carefully cut open the tag with your knife and peel back the plastic to reveal a blank memory chip.

>take memory
Taken.

>drop white shirt's tag
Dropped.

>cut red jacket's tag with knife
Taken.

You carefully cut open the tag with your knife and peel back the plastic to reveal a blank memory chip.

>take memory
Taken.

>drop red jacket's tag
Dropped.

>put memory chip in id camera
You put the blank memory chip into the film slot.

>put blank memory chip in thermos
You put the blank memory chip into the thermos.

>g
You put the blank memory chip into the thermos.

>g
You put the blank memory chip into the thermos.

>i
You are carrying:
  a lockblade knife
  a tag remover
  a backpack (being worn, and open)
    an ID camera
    a thermos (open)
      three blank memory chips
    a blue jacket
    a soldering iron
    some solder
    a tablet computer
    a cotter pin
    a pager (open but empty)
    a lost camera
    a newspaper
    a post-it
    a safety limiter
    a car key
      a receive chip
  a multitool
  a watch (being worn)

>put knife in pack
You put the lockblade knife into the backpack.

>w
The Proletariat Bar
The Proletariat is a local bar (not a pub).  It's just far enough above a "dive" to be allowed zoning here, but steadfastedly refuses to cater to upscale tastes.  You like it.  Restrooms are to the east; the bar runs along the north side with a stolid bartender behind it and a jukebox sits against the back wall.  A few hardy drinkers sit here, communing with their spirits.  In a nod to the place's name, a Public Surveillance Notice covered with stickers and graffiti tags has been framed above the bar.

You can see a Bartender and a man here.

You can go northwest to Green Commercial Plaza North, southwest to Green Commercial Plaza South, east to Proletariat Restroom, and west to Green Commercial Plaza Center from here.

There is a Public Surveillance Notice here.

>w
Green Commercial Plaza Center
This is the center of the Green Commercial Plaza.  There is a fountain here with a bench facing it.  The plaza continues to the north and south; to the east is a bar called (ironically, you hope) the Proletariat.  To the west is a Bistro Paris cafe.

The Reserve Bank Spacescraper is visible in the distance, rising over the low skyline.

You can also see a trash can (in which is some rubbish) here.

You can go north to Green Commercial Plaza North, northeast to RoughIt, northwest, south to Green Commercial Plaza South, southeast, east to The Proletariat Bar, and west to Green Commercial Bistro Paris from here.

There is a Public Surveillance Notice here.

>w
Green Commercial Bistro Paris
This is a branch of the popular lunch and coffee shop Bistro Paris.  There are a few tables near the front.  A restroom is to the west.  On the north wall, opposite the counter, is a collection of Paris-themed prints.  In the center is a large holoportrait of the chain's owner, Zuzu, and a sign claiming that the Bistro Paris has restaurants here, in the Reserve Bank Spacescraper, and in London.  A server behind the counter is waiting on several customers.

You can see a trash can (closed) here.

You can go northeast to Green Commercial Plaza North, southeast to Green Commercial Plaza South, east to Green Commercial Plaza Center, and west from here.

There is a Public Surveillance Notice here.

>x holo
This portrait is somewhat horribly overdone.  In it, Zuzu's face, in three-quarter profile, floats in front of what appears to be this very restaurant.  Her face is so large and detailed that you're sure they had to edit out her pores, although they probably left her bright green eye unretouched.

>take picture of zuzu's eye with id camera
Taken.

The camera emits an artificial-sounding "CLICK" noise.
  The disc icon flashes green, indicating that the image has been stored.

>i
You are carrying:
  an ID camera
  a tag remover
  a backpack (being worn, and open)
    a lockblade knife
    a thermos (open)
      three blank memory chips
    a blue jacket
    a soldering iron
    some solder
    a tablet computer
    a cotter pin
    a pager (open but empty)
    a lost camera
    a newspaper
    a post-it
    a safety limiter
    a car key
      a receive chip
  a multitool
  a watch (being worn)

>look in id camera
In the film slot is a photo memory chip.

>take memory
Which do you mean, the photo memory chip or a blank memory chip?

>e
I only understood you as far as wanting to take east.

>e
Green Commercial Plaza Center
This is the center of the Green Commercial Plaza.  There is a fountain here with a bench facing it.  The plaza continues to the north and south; to the east is a bar called (ironically, you hope) the Proletariat.  To the west is a Bistro Paris cafe.

The Reserve Bank Spacescraper is visible in the distance, rising over the low skyline.

You can also see a trash can (in which is some rubbish) here.

You can go north to Green Commercial Plaza North, northeast to RoughIt, northwest, south to Green Commercial Plaza South, southeast, east to The Proletariat Bar, and west to Green Commercial Bistro Paris from here.

There is a Public Surveillance Notice here.

>se
Accessorize
This well-lit store purveys all manner of cosmetic aids and fashion accessories.  Everything from wrist bangles to skin creams to custom cosmetic contacts can be purchased here.

You can see a Lens Crafter here.

You can go northwest to Green Commercial Plaza Center and west to Green Commercial Plaza South from here.

There is a Public Surveillance Notice here.

>x lens crafter
A floor-standing device used to produce custom-made cosmetic contact lenses (although for an extra fee, they can be made to a prescription).  A screen on the front presents a menu of options, or a Memory with appropriate specifications can be inserted into a data slot .

The Lens Crafter is currently switched off.

>put photo memory into slot
Which do you mean, the delivery slot, the data slot, the film slot, or the chipslot?

>put photo memory into lens crafter
You put the photo memory chip into the data slot.

>switch on lens crafter
The lens crafter machine's screen flashes green.  A message reads "SOURCE DATA ACCEPTED - COSTUME LENS SYNTHESIZED."  The machine hisses slightly, and a sleeve descends around the lens case.  When the sleeve retracts, the lens case is closed.

>take lens case
Taken.

>open lens case
You open the lens case.

>x lens case
A small clear plastic cylinder with a built-in rest for a contact lens inside.

In the lens case is a contact lens.

>wear contact lens
(first taking the contact lens)
You put on the contact lens.

>put lens case and id camera in pack
lens case: Done.
ID camera: Done.

>take photo memory
Taken.

>put photo memory in fob
You put the photo memory chip into the car key.

>x fob
This "key" is really a small rubberized, sealed plastic fob which automatically unlocks the car it is paired with when it is within range.  You have no idea where the appropriate car might be, however. The plastic has been cut away from one end of the key, revealing two component slots.

In the car key are a photo memory chip and a receive chip.

>w
Green Commercial Plaza South
The southern end of the Green Commercial Plaza, which continues to the north.  To the east is Accessorize, a fashion store, and to the west is Garb-oh, a trendy clothing shop.  The south end of the mall is closed off by an elaborate landscaping installation of trees and shrubs, presumably to hide a relatively ugly building behind it.

The Reserve Bank Spacescraper is visible in the distance, rising over the low skyline.

A parked police flitter, armored and festooned with lights, looms here.

You can also see a trash can (closed) here.

You can go north to Green Commercial Plaza Center, northeast to The Proletariat Bar, northwest to Green Commercial Bistro Paris, east to Accessorize, and west through the Garb-oh door (closed) to Garb-oh from here.

There is a Public Surveillance Notice here.

>wait 15 minutes
It is now 11:42 pm.

>wait 15 minutes
Officer Prescott ambles out of Green Commercial Bistro Paris.  As he approaches the flitter, the flitterkey transponder on his belt disables the locklarm.
He then climbs into the flitter and shuts the door.  A few moments later, the aircraft powers up. The turbines spool up and, its beacons flashing, it lifts smoothly into the air, disappearing behind the building tops.
Your hacked car key beeps softly!

You hear a very quiet beep from somewhere you can't identify.

You hear a very quiet beep from somewhere you can't identify.

It is now 11:57 pm.

>x fob
This "key" is really a small rubberized, sealed plastic fob which automatically unlocks the car it is paired with when it is within range.  You have no idea where the appropriate car might be, however. The plastic has been cut away from one end of the key, revealing two component slots.

In the car key are a transponder memory chip and a receive chip.

>ne
The Proletariat Bar
The Proletariat is a local bar (not a pub).  It's just far enough above a "dive" to be allowed zoning here, but steadfastedly refuses to cater to upscale tastes.  You like it.  Restrooms are to the east; the bar runs along the north side with a stolid bartender behind it and a jukebox sits against the back wall.  A few hardy drinkers sit here, communing with their spirits.  In a nod to the place's name, a Public Surveillance Notice covered with stickers and graffiti tags has been framed above the bar.

You can see a Bartender and a man here.

You can go northwest to Green Commercial Plaza North, southwest to Green Commercial Plaza South, east to Proletariat Restroom, and west to Green Commercial Plaza Center from here.

There is a Public Surveillance Notice here.

>e
Proletariat Restroom
The one-holer restroom at the Proletariat is cleaner than you might think, although that may be due to the fact that it is midweek.  A scratched mirror over the sink has been covered with marker graffiti.

You can see a red jacket's antitheft tag, a white shirt's antitheft tag, a green shirt's antitheft tag, a blue jacket's antitheft tag, and a trash can (closed) here.

You can go west to The Proletariat Bar from here.

>x trash can
Painted industrial dark green, the Proletariat Restroom trash can awaits its daily diet of rubbish.  There is a solar panel on it; presumably it reports back to a central system when it is full.

>open solar panel with multitool
You pry open the solar panel with the pliers in your multitool, ignoring the sound of breaking plastic.

Opening the solar panel reveals the broadcast chip!

>take broadcast
Taken.

>w
The Proletariat Bar
The Proletariat is a local bar (not a pub).  It's just far enough above a "dive" to be allowed zoning here, but steadfastedly refuses to cater to upscale tastes.  You like it.  Restrooms are to the east; the bar runs along the north side with a stolid bartender behind it and a jukebox sits against the back wall.  A few hardy drinkers sit here, communing with their spirits.  In a nod to the place's name, a Public Surveillance Notice covered with stickers and graffiti tags has been framed above the bar.

You can see a Bartender and a man here.

You can go northwest to Green Commercial Plaza North, southwest to Green Commercial Plaza South, east to Proletariat Restroom, and west to Green Commercial Plaza Center from here.

There is a Public Surveillance Notice here.

>sw
Green Commercial Plaza South
The southern end of the Green Commercial Plaza, which continues to the north.  To the east is Accessorize, a fashion store, and to the west is Garb-oh, a trendy clothing shop.  The south end of the mall is closed off by an elaborate landscaping installation of trees and shrubs, presumably to hide a relatively ugly building behind it.

The Reserve Bank Spacescraper is visible in the distance, rising over the low skyline.

You can also see a trash can (closed) here.

You can go north to Green Commercial Plaza Center, northeast to The Proletariat Bar, northwest to Green Commercial Bistro Paris, east to Accessorize, and west through the Garb-oh door (closed) to Garb-oh from here.

There is a Public Surveillance Notice here.

>wait 15 minutes
A police flitter spirals slowly down out of the sky, beacons strobing and warning tones blaring.  It comes to a rest in the clear area in the middle of the plaza and powers down.  Officer Prescott gets out, closes the door and ambles off towards the Bistro nearby, probably to get a coffee.

It is now 12:17 am.

>take receive
Taken.

>put broadcast in fob
The police flitter flashes its lights twice as the locklarm disengages.

You put the broadcast chip into the car key.

>open flitter
You open the police flitter, revealing a disarmed tear gas grenade and a harness.

>take grenade and harness
disarmed tear gas grenade: Taken.
harness: Taken.

>put grenade and harness and fob in pack
disarmed tear gas grenade: Done.
harness: Done.
car key: Done.

>n
Green Commercial Plaza Center
This is the center of the Green Commercial Plaza.  There is a fountain here with a bench facing it.  The plaza continues to the north and south; to the east is a bar called (ironically, you hope) the Proletariat.  To the west is a Bistro Paris cafe.

The Reserve Bank Spacescraper is visible in the distance, rising over the low skyline.

You can also see a trash can (in which is some rubbish) here.

You can go north to Green Commercial Plaza North, northeast to RoughIt, northwest, south to Green Commercial Plaza South, southeast to Accessorize, east to The Proletariat Bar, and west to Green Commercial Bistro Paris from here.

There is a Public Surveillance Notice here.

>n
Green Commercial Plaza North
Green Commercial One is built around a plaza, and this is its northern end.  No vehicles are permitted within the public areas of Green Commercial One, so the entire area is pedestrian-only.  To the north are the doorways to the Green Commercial Station.  To the east is RoughIt.  To the west is a storefront bank with an ATM.  The plaza continues to the south.

The Reserve Bank Spacescraper is visible in the distance, rising over the low skyline.

You can also see a trash can (closed) here.

You can go north to Green Commercial Station, south to Green Commercial Plaza Center, southeast to The Proletariat Bar, southwest to Green Commercial Bistro Paris, east to RoughIt, and west from here.

There is a Public Surveillance Notice here.

>n
Green Commercial Station
Green Commercial One's Transit station usually does most of its business around the rush hours, as Green Residental commuters stop off to take care of errands.  The station is relatively small, but well kept up - the Green Commercial Business Improvement District organization sees to that.  Open doorways lead south to Green Commercial One proper, and a stairway leads down to the doors to the Transit platform.

You can go south to Green Commercial Plaza North and down through the Green Commercial Station door (closed) to Green Commercial Platform from here.

There is a Public Surveillance Notice here.

* * *

>wait for capsule
A light grows in the tunnel.  With a deep thrumming and the whoosh of displaced air, the Transit Capsule slides smoothly into Green Commercial Platform and comes to a stop, hovering in the Web.  The doors slide open and a few commuters enter and exit the capsule.
A few commuters get on and off the Transit capsule.

>enter capsule
You move into the Transit Capsule.

Transit Capsule
A fifty-person maglev Transit capsule.  You're standing, holding on to a strap.  Through the windows you can see the Green Commercial Platform. Several riders share the Capsule with you.

There is a Public Surveillance Notice here.

A few riders get on and off the Transit capsule.

>wait for service
(Green Service Platform)
A few riders get on and off the Transit capsule.

The capsule doors slide shut.  The humming noice increases in volume, and the capsule slides out of the station, gathering speed as it goes, and slides into the tunnel..

You hold onto your strap as the Capsule rapidly accelerates.

A nearby commuter's handheld begins beeping loudly.  She hurriedly shuts it off.

A man nearby yawns.

With a deep thrumming and the whoosh of displaced air, the Transit Capsule slides smoothly into Green Residential Platform and comes to a stop, hovering in the Web.  The doors slide open and a few commuters enter and exit the capsule.
A few riders get on and off the Transit capsule.

A few riders get on and off the Transit capsule.

A few riders get on and off the Transit capsule.

The capsule doors slide shut.  The humming noice increases in volume, and the capsule slides out of the station, gathering speed as it goes, and slides into the tunnel..

You hold onto your strap as the Capsule rapidly accelerates.

The capsule shudders as it passes a junction in the Web.

With a deep thrumming and the whoosh of displaced air, the Transit Capsule slides smoothly into Green Service Platform and comes to a stop, hovering in the Web.  The doors slide open and a few commuters enter and exit the capsule.
A few riders get on and off the Transit capsule.

>exit
Green Service Platform
Green Service One's platform is underground.  It serves mostly city workers during the day.  There is an exit at the center of the platform which leads north through a set of closed automatic doors to a stairway leading up to the main station, just next to a large plaque with the name of the station on it.  The platform abuts the Transit web to the south, where a Transit capsule hovers impatiently in the web.  The capsule doors are open.

You can see a Transit Map here.

You can go north through the Green Service Station door (closed) to Green Service Station from here.

There is a Public Surveillance Notice here.

A few commuters get on and off the Transit capsule.

* * *

>n
(first opening the Green Service Station door)

Green Service Station
Green Service is the local government services cluster.  The Transit station seems to reflect this, exhibiting a weary conformity - although you couldn't say exactly how.  A stairway leads down to the platform access doors, and a set of doorways lead north out onto Government Square.

You can go north to Government Square South and down through the Green Service Station door to Green Service Platform from here.

There is a Public Surveillance Notice here.

The automatic door slides closed.

>n
Government Square South
This is the southern half of Government Square.  Several benches and landscape features are scattered throughout the area.  A roadway approaches from the west, loops north around the square and continues to the east.  Groundcars move back and forth along the road, mixed with official vehicles such as police cars, ambulances and the ubiquitous slightly shabby black flitters used by government agencies.  The doors to Green Service Transit station are to the south.  Across the road to the east is Green Hospital's driveway.  The Hospital's main entrance is to the northeast.  The square continues to the north.  To the northwest, across the road on the other side, is the front steps of the local police station.

The Reserve Bank Spacescraper is visible in the distance, rising over the low skyline.

You can go north to Government Square North, northeast, northwest to Police Station Steps, south to Green Service Station, and east from here.

There is a Public Surveillance Notice here.

>e
Hospital Driveway
The driveway and parking area for the Hospital ER, which lies directly to the east.  To the north is the main entrance to the Hospital building.

The Reserve Bank Spacescraper is visible in the distance, rising over the low skyline.

An ambulance, a bulky flittervan with emergency markings, is parked here.

You can go north, northwest to Government Square North, east through the ER door (closed), and west to Government Square South from here.

The ambulance flashes its lights twice as the locklarm unlocks the back.

There is a Public Surveillance Notice here.

>open ambulance
You open the ambulance, revealing a tissue sampler and a medical camera.

>take tissue sampler and medical camera
tissue sampler: Taken.
medical camera: Taken.

>put medical camera in pack
You put the medical camera into the backpack.

>w
Government Square South
This is the southern half of Government Square.  Several benches and landscape features are scattered throughout the area.  A roadway approaches from the west, loops north around the square and continues to the east.  Groundcars move back and forth along the road, mixed with official vehicles such as police cars, ambulances and the ubiquitous slightly shabby black flitters used by government agencies.  The doors to Green Service Transit station are to the south.  Across the road to the east is Green Hospital's driveway.  The Hospital's main entrance is to the northeast.  The square continues to the north.  To the northwest, across the road on the other side, is the front steps of the local police station.

The Reserve Bank Spacescraper is visible in the distance, rising over the low skyline.

You can go north to Government Square North, northeast, northwest to Police Station Steps, south to Green Service Station, and east to Hospital Driveway from here.

There is a Public Surveillance Notice here.

>s
Green Service Station
Green Service is the local government services cluster.  The Transit station seems to reflect this, exhibiting a weary conformity - although you couldn't say exactly how.  A stairway leads down to the platform access doors, and a set of doorways lead north out onto Government Square.

You can go north to Government Square South and down through the Green Service Station door (closed) to Green Service Platform from here.

There is a Public Surveillance Notice here.

>d
(first opening the Green Service Station door)

Green Service Platform
Green Service One's platform is underground.  It serves mostly city workers during the day.  There is an exit at the center of the platform which leads north through a set of closed automatic doors to a stairway leading up to the main station, just next to a large plaque with the name of the station on it.  The platform abuts the Transit web to the south, now empty.

You can see a Transit Map here.

You can go north through the Green Service Station door to Green Service Station from here.

There is a Public Surveillance Notice here.

The automatic door slides closed.

>wait for capsule
A commuter walks by.

A commuter walks by.

A light grows in the tunnel.  With a deep thrumming and the whoosh of displaced air, the Transit Capsule slides smoothly into Green Service Platform and comes to a stop, hovering in the Web.  The doors slide open and a few commuters enter and exit the capsule.
A few commuters get on and off the Transit capsule.

>enter capsule
You move into the Transit Capsule.

Transit Capsule
A fifty-person maglev Transit capsule.  You're standing, holding on to a strap.  Through the windows you can see the Green Service Platform. Several riders share the Capsule with you.

There is a Public Surveillance Notice here.

A few riders get on and off the Transit capsule.

>wait for commercial
(Green Commercial Platform)
A few riders get on and off the Transit capsule.

The capsule doors slide shut.  The humming noice increases in volume, and the capsule slides out of the station, gathering speed as it goes, and slides into the tunnel..

You hold onto your strap as the Capsule rapidly accelerates.

A shabbily-dressed man wanders up to you.  He appears to be about to ask you for something, but then he catches a look at your eyes and instead wanders away again.

You see a small red light in the corner of your vision which vanishes as you turn to look at it.

With a deep thrumming and the whoosh of displaced air, the Transit Capsule slides smoothly into Reserve Bank Station and comes to a stop, hovering in the Web.  The doors slide open and a few commuters enter and exit the capsule.
A few riders get on and off the Transit capsule.

A few riders get on and off the Transit capsule.

A few riders get on and off the Transit capsule.

The capsule doors slide shut.  The humming noice increases in volume, and the capsule slides out of the station, gathering speed as it goes, and slides into the tunnel..

You hold onto your strap as the Capsule rapidly accelerates.

You find yourself mesmerized by an advertisement for disposable cameras.

With a deep thrumming and the whoosh of displaced air, the Transit Capsule slides smoothly into Green Commercial Platform and comes to a stop, hovering in the Web.  The doors slide open and a few commuters enter and exit the capsule.
A few riders get on and off the Transit capsule.

>exit
Green Commercial Platform
Green Commercial One is one of the oldest stations on the Transit web.  Although it has been refurbished several times, its age still manages to show through the layers of tile and paint.  The platform opens out at the middle to a lobby area which is dominated by a row of automated doors to the south, which lead to stairways up to the main station.  The flow of commuters moves steadily through these doors.  The floor and walls are both extremely scuffed duramex nanotile, and the station name (Green Commercial One) is indicated on a large plaque set into the walls. The platform abuts the Transit web to the north, where a Transit capsule can be seen hovering.  The capsule doors are open.

You can see a Transit Map here.

You can go south through the Green Commercial Station door (closed) to Green Commercial Station from here.

There is a Public Surveillance Notice here.

A few commuters get on and off the Transit capsule.

* * *

>s
Green Commercial Plaza North
Green Commercial One is built around a plaza, and this is its northern end.  No vehicles are permitted within the public areas of Green Commercial One, so the entire area is pedestrian-only.  To the north are the doorways to the Green Commercial Station.  To the east is RoughIt.  To the west is a storefront bank with an ATM.  The plaza continues to the south.

The Reserve Bank Spacescraper is visible in the distance, rising over the low skyline.

You can also see a trash can (closed) here.

You can go north to Green Commercial Station, south to Green Commercial Plaza Center, southeast to The Proletariat Bar, southwest to Green Commercial Bistro Paris, east to RoughIt, and west from here.

There is a Public Surveillance Notice here.

>w
Metro Savings
This is a completely nondescript bank storefront which exists solely to house an ATM.  It's so nondescript, in fact, that it took you some actual effort to determine which bank owns it, probably to ensure that they can charge you access fees no matter what.  To the east is Green Commercial Plaza.

You can see an ATM here.

You can go southeast to Green Commercial Plaza Center and east to Green Commercial Plaza North from here.

There is a Public Surveillance Notice here.

>put tissue sampler in palm reader
You carefully fit the tissue sampler into the hollow of the palm reader so that it lies over the read area.

>e
Green Commercial Plaza North
Green Commercial One is built around a plaza, and this is its northern end.  No vehicles are permitted within the public areas of Green Commercial One, so the entire area is pedestrian-only.  To the north are the doorways to the Green Commercial Station.  To the east is RoughIt.  To the west is a storefront bank with an ATM.  The plaza continues to the south.

The Reserve Bank Spacescraper is visible in the distance, rising over the low skyline.

You can also see a trash can (closed) here.

You can go north to Green Commercial Station, south to Green Commercial Plaza Center, southeast to The Proletariat Bar, southwest to Green Commercial Bistro Paris, east to RoughIt, and west to Metro Savings from here.

There is a Public Surveillance Notice here.

>se
The Proletariat Bar
The Proletariat is a local bar (not a pub).  It's just far enough above a "dive" to be allowed zoning here, but steadfastedly refuses to cater to upscale tastes.  You like it.  Restrooms are to the east; the bar runs along the north side with a stolid bartender behind it and a jukebox sits against the back wall.  A few hardy drinkers sit here, communing with their spirits.  In a nod to the place's name, a Public Surveillance Notice covered with stickers and graffiti tags has been framed above the bar.

You can see a Bartender and a man here.

You can go northwest to Green Commercial Plaza North, southwest to Green Commercial Plaza South, east to Proletariat Restroom, and west to Green Commercial Plaza Center from here.

There is a Public Surveillance Notice here.

>x man
A medium-height man of middle age and dark but somewhat pasty-looking skin.  His hair, black and cut short, is just beginning to grey at the temples.  His hands are rough and callused.  He is wearing work shoes and dark blue trousers, slightly scuffed.  He is wearing a dark blue trade uniform jacket with a long narrow gash at the left shoulder and his name (Roberto Velez) on a tag clipped to the breast.

>roberto, tell me about the reserve bank
Roberto sighs.  "I have a good job," he says.  "I am a custodian there at the Reserve Bank, downtown.  The work is not bad, and the pay is not terrible, but they are very strict about the uniform."

>roberto, tell me about your jacket
Roberto cranes his head to look at the damage.  "Oh, yes," he says.  "This happened at work.  I caught it on a shelf."  He shakes his head dolefully.  "They are making me pay for the jacket," he says to you, "but they are charging me the new price for it!  The price, it is ridiculous!  I would replace it myself but I cannot afford one like it.  I will have to let them dock my pay for months."

>give blue jacket to roberto
(Roberto Velez)
(first taking the blue jacket)
Roberto stands up and eagerly examines the blue jacket.  "This would be a perfect replacement!" he says enthusiastically, showing you how closely it resembles his torn uniform jacket.  "Would you be willing to part with it? I cannot give you much, but I would happily pay you what I can; it will be less than what those dogs would take from my salary to replace this one!" He pats his pockets, then shakes his head.  "I need to go to the ATM."  With that, he stands up.

Roberto Velez goes northwest.

>nw
Green Commercial Plaza North
Green Commercial One is built around a plaza, and this is its northern end.  No vehicles are permitted within the public areas of Green Commercial One, so the entire area is pedestrian-only.  To the north are the doorways to the Green Commercial Station.  To the east is RoughIt.  To the west is a storefront bank with an ATM.  The plaza continues to the south.

The Reserve Bank Spacescraper is visible in the distance, rising over the low skyline.

You can also see Roberto Velez and a trash can (closed) here.

You can go north to Green Commercial Station, south to Green Commercial Plaza Center, southeast to The Proletariat Bar, southwest to Green Commercial Bistro Paris, east to RoughIt, and west to Metro Savings from here.

There is a Public Surveillance Notice here.

Roberto Velez goes west.

>w
Metro Savings
This is a completely nondescript bank storefront which exists solely to house an ATM.  It's so nondescript, in fact, that it took you some actual effort to determine which bank owns it, probably to ensure that they can charge you access fees no matter what.  To the east is Green Commercial Plaza.

You can see Roberto Velez and an ATM here.

You can go southeast to Green Commercial Plaza Center and east to Green Commercial Plaza North from here.

There is a Public Surveillance Notice here.

Roberto approaches the ATM, intent on withdrawing funds to pay you for the blue jacket.
Roberto places his palm on the sampler, hidden inside the ATM.  It flashes briefly.  Nothing else happens.
He shakes his head.  "I am sorry, but the machine is broken."  You reassure him that you don't need paying for the jacket, at which he breaks out into a huge smile, gives you a hug, shakes your hand and quickly changes into the new blue jacket, dropping his torn jacket.  He walks out of the ATM, proudly fingering his new wardrobe.

>wear torn jacket
(first taking the torn jacket)
You put on the torn jacket.

>take tissue sampler
Taken.

>e
Green Commercial Plaza North
Green Commercial One is built around a plaza, and this is its northern end.  No vehicles are permitted within the public areas of Green Commercial One, so the entire area is pedestrian-only.  To the north are the doorways to the Green Commercial Station.  To the east is RoughIt.  To the west is a storefront bank with an ATM.  The plaza continues to the south.

The Reserve Bank Spacescraper is visible in the distance, rising over the low skyline.

You can also see a trash can (closed) here.

You can go north to Green Commercial Station, south to Green Commercial Plaza Center, southeast to The Proletariat Bar, southwest to Green Commercial Bistro Paris, east to RoughIt, and west to Metro Savings from here.

There is a Public Surveillance Notice here.

>n
Green Commercial Station
Green Commercial One's Transit station usually does most of its business around the rush hours, as Green Residental commuters stop off to take care of errands.  The station is relatively small, but well kept up - the Green Commercial Business Improvement District organization sees to that.  Open doorways lead south to Green Commercial One proper, and a stairway leads down to the doors to the Transit platform.

You can go south to Green Commercial Plaza North and down through the Green Commercial Station door (closed) to Green Commercial Platform from here.

There is a Public Surveillance Notice here.

* * *

>wait for capsule
A commuter walks by.

Warning lights along the platform edge begin to blink rapidly.  A light grows in the tunnel.  With a deep moan and gust of wind, an express Transit Capsule blasts through Green Commercial One.  To your shock, a human figure closely follows the Capsule, suspended in the Magfield of the Transit Web!  It is wearing mirrorshades and what appear to be glowing bracelets and anklets.  Before you can make out anything else, the Capsule has vanished into the darkness, leading its strange follower away.  You're not sure you really saw that.

A commuter walks by.

A light grows in the tunnel.  With a deep thrumming and the whoosh of displaced air, the Transit Capsule slides smoothly into Green Commercial Platform and comes to a stop, hovering in the Web.  The doors slide open and a few commuters enter and exit the capsule.
A few commuters get on and off the Transit capsule.

>enter capsule
You move into the Transit Capsule.

Transit Capsule
A fifty-person maglev Transit capsule.  You're standing, holding on to a strap.  Through the windows you can see the Green Commercial Platform. Several riders share the Capsule with you.

There is a Public Surveillance Notice here.

A few riders get on and off the Transit capsule.

>wait for residential
(Green Residential Platform)
A few riders get on and off the Transit capsule.

The capsule doors slide shut.  The humming noice increases in volume, and the capsule slides out of the station, gathering speed as it goes, and slides into the tunnel..

You hold onto your strap as the Capsule rapidly accelerates.

With a deep thrumming and the whoosh of displaced air, the Transit Capsule slides smoothly into Green Residential Platform and comes to a stop, hovering in the Web.  The doors slide open and a few commuters enter and exit the capsule.
A few riders get on and off the Transit capsule.

You hear a very quiet beep from somewhere you can't identify.

>exit
Green Residential Platform
Green Residential's platform serves mostly residential commuters.  There is an exit at the center of the platform which leads east through a set of closed automatic doors to a stairway leading up to the main station, just next to a large plaque with the name of the station on it.  The platform abuts the Transit web to the west, where a Transit capsule hovers impatiently.  The capsule doors are open.

You can see a Transit Map here.

You can go east through the Green Residential Station door (closed) to Green Residential Station from here.

There is a Public Surveillance Notice here.

A few commuters get on and off the Transit capsule.

>e
(first opening the Green Residential Station door)
The Eye Scanner laser delicately probes your iris, and the doors slide smoothly open.

Green Residential Station
This is a utilitarian shelter intended mostly to keep the rain out of the Transit System.  A stairway leads down to the autodoor leading to the Transit platform and an exit leads east to the street.

You can go east to Primrose & Station and down through the Green Residential Station door to Green Residential Platform from here.

There is a Public Surveillance Notice here.

The automatic door slides closed.

* * *

>e
Primrose & Station
This staid neighborhood intersection of Primrose Lane and Cedar Street fronts the local Transit station, Green Residential.  The station entrance is to the west.  Primrose Lane continues to the south.

The Reserve Bank Spacescraper is visible in the distance, rising over the low skyline.

You can go north to Green Residential Park, south to South Primrose Lane, and west to Green Residential Station from here.

There is a Public Surveillance Notice here.

>s
South Primrose Lane
Primrose Lane continues to the north.  To the south is a boarded-up empty house; sumac plants can be seen peeking over the top of the dilapidated fencing.  The fence has a plastic tarp strung behind it which prevents you from seeing much of the house.  To the west is a single-family home with a large warning sign and an enormous dog on the front lawn.  To the east is a three-family residence's front path.

The Reserve Bank Spacescraper is visible in the distance, rising over the low skyline.

You can go north to Primrose & Station, south to Drug Market, and east to Front Path from here.

There is a Public Surveillance Notice here.

You arrive at South Primrose Lane to a scene of chaos.  Police vehicles are pulled up all over the road, cyclone lights flashing.  As you watch, heavily armed SWAT officers file through the hole in the fence towards the Drug Market.   A staticky transmission over the radio of the vehicles near you says quietly "Breaching charges in place."  You can hear a voice on a bullhorn shout "You have thirty seconds to surrender!"

A few seconds later, there is a deep thundering BOOM as the breaching charges detonate, and a confused hubbub as (presumably) the SWAT officers rush into the abandoned house.

>z
Time passes.

>z
Time passes.

Eventually, police begin filing back out of the hole in the fence, dragging a few handcuffed suspects with them.  The bright lights across the fence go out, and various SWAT and regular police get back into their assorted vehicles and begin to pull away.  Soon nothing is left except a slight smell of smoke from the breaching charges.

>s
Drug Market
Standing just south of the fence, you see an abandoned house on the south side of the lot. The front yard is a mess of trash and litter.  The area is empty of people; yellow police line tape covers the empty front doorway.

The Reserve Bank Spacescraper is visible in the distance, rising over the low skyline.

You can go north to South Primrose Lane and south from here.

>s
Drug Den
The empty ruins of a drug market hangout.  The SWAT team's breaching charges have blown the heavy metal main door into the hallway.  The house is thoroughly trashed, and rubble prevents you from moving any further into the building.  Discarded drug paraphernalia and random trash litters the floor.

You can see a metal door (on which is a disarmed breaching charge) here.

You can go north to Drug Market from here.

>take charge
Taken.

>put charge in pack
You put the disarmed breaching charge into the backpack.

>n
Drug Market
Standing just south of the fence, you see an abandoned house on the south side of the lot. The front yard is a mess of trash and litter.  The area is empty of people; yellow police line tape covers the empty front doorway.

The Reserve Bank Spacescraper is visible in the distance, rising over the low skyline.

You can go north to South Primrose Lane and south to Drug Den from here.

>n
South Primrose Lane
Primrose Lane continues to the north.  To the south is a boarded-up empty house; sumac plants can be seen peeking over the top of the dilapidated fencing.  The fence has a plastic tarp strung behind it which prevents you from seeing much of the house.  To the west is a single-family home with a large warning sign and an enormous dog on the front lawn.  To the east is a three-family residence's front path.

The Reserve Bank Spacescraper is visible in the distance, rising over the low skyline.

You can go north to Primrose & Station, south to Drug Market, and east to Front Path from here.

There is a Public Surveillance Notice here.

* * *

>wait for capsule
Warning lights along the platform edge begin to blink rapidly.  A light grows in the tunnel.  With a deep moan and gust of wind, an express Transit Capsule blasts through Green Residential.  To your shock, a human figure closely follows the Capsule, suspended in the Magfield of the Transit Web!  It is wearing mirrorshades and what appear to be glowing bracelets and anklets.  Before you can make out anything else, the Capsule has vanished into the darkness, leading its strange follower away.  You're not sure you really saw that.

A light grows in the tunnel.  With a deep thrumming and the whoosh of displaced air, the Transit Capsule slides smoothly into Green Residential Platform and comes to a stop, hovering in the Web.  The doors slide open and a few commuters enter and exit the capsule.
A few commuters get on and off the Transit capsule.

>enter capsule
You move into the Transit Capsule.

Transit Capsule
A fifty-person maglev Transit capsule.  You're standing, holding on to a strap.  Through the windows you can see the Green Residential Platform. Several riders share the Capsule with you.

There is a Public Surveillance Notice here.

A few riders get on and off the Transit capsule.

>wait for service
(Green Service Platform)
A few riders get on and off the Transit capsule.

The capsule doors slide shut.  The humming noice increases in volume, and the capsule slides out of the station, gathering speed as it goes, and slides into the tunnel..

You hold onto your strap as the Capsule rapidly accelerates.

With a deep thrumming and the whoosh of displaced air, the Transit Capsule slides smoothly into Green Service Platform and comes to a stop, hovering in the Web.  The doors slide open and a few commuters enter and exit the capsule.
A few riders get on and off the Transit capsule.

>exit
Green Service Platform
Green Service One's platform is underground.  It serves mostly city workers during the day.  There is an exit at the center of the platform which leads north through a set of closed automatic doors to a stairway leading up to the main station, just next to a large plaque with the name of the station on it.  The platform abuts the Transit web to the south, where a Transit capsule hovers impatiently in the web.  The capsule doors are open.

You can see a Transit Map here.

You can go north through the Green Service Station door (closed) to Green Service Station from here.

There is a Public Surveillance Notice here.

A few commuters get on and off the Transit capsule.

A police officer strolls through the area, giving you a suspicious look before moving on.

>n
(first opening the Green Service Station door)

Green Service Station
Green Service is the local government services cluster.  The Transit station seems to reflect this, exhibiting a weary conformity - although you couldn't say exactly how.  A stairway leads down to the platform access doors, and a set of doorways lead north out onto Government Square.

You can go north to Government Square South and down through the Green Service Station door to Green Service Platform from here.

There is a Public Surveillance Notice here.

The automatic door slides closed.

>n
Government Square South
This is the southern half of Government Square.  Several benches and landscape features are scattered throughout the area.  A roadway approaches from the west, loops north around the square and continues to the east.  Groundcars move back and forth along the road, mixed with official vehicles such as police cars, ambulances and the ubiquitous slightly shabby black flitters used by government agencies.  The doors to Green Service Transit station are to the south.  Across the road to the east is Green Hospital's driveway.  The Hospital's main entrance is to the northeast.  The square continues to the north.  To the northwest, across the road on the other side, is the front steps of the local police station.

The Reserve Bank Spacescraper is visible in the distance, rising over the low skyline.

You can go north to Government Square North, northeast, northwest to Police Station Steps, south to Green Service Station, and east to Hospital Driveway from here.

There is a Public Surveillance Notice here.

>e
Hospital Driveway
The driveway and parking area for the Hospital ER, which lies directly to the east.  To the north is the main entrance to the Hospital building.

The Reserve Bank Spacescraper is visible in the distance, rising over the low skyline.

An ambulance, a bulky flittervan with emergency markings, is parked here.

You can go north, northwest to Government Square North, east through the ER door (closed), and west to Government Square South from here.

The ambulance flashes its lights twice as the locklarm unlocks the back.

There is a Public Surveillance Notice here.

>e
(first opening the ER door)

Triage
This is a triage area for the ER to the east.  To the north is the main Hospital lobby, and west lies the automatic doors out to the driveway.  Patients and staff are moving back and forth through the area.

You can go north, east, and west through the ER door to Hospital Driveway from here.

There is a Public Surveillance Notice here.

The automatic door slides closed.

>e
Emergency Room
This is a prep and emergency treatment area for the emergency ward to the east, which is locked.  Triage is to the west, and a door leads north.  The ER is presently unused, and lies empty.

You can see a tissue generator here.

You can go north and west to Triage from here.

There is a Public Surveillance Notice here.

>put tissue sampler in sample slot
Some form of container to hold the sample is needed here.

>put tissue sampler in read slot
You put the tissue sampler (Roberto) into the read slot.

>i
You are carrying:
  a torn jacket (being worn)
  a receive chip
  a contact lens (being worn)
  a tag remover
  a backpack (being worn, and open)
    a disarmed breaching charge
    a medical camera
    a car key
      a broadcast chip
      a transponder memory chip
    a harness
    a disarmed tear gas grenade
    an ID camera
    a lens case (open but empty)
    a lockblade knife
    a thermos (open)
      three blank memory chips
    a soldering iron
    some solder
    a tablet computer
    a cotter pin
    a pager (open but empty)
    a lost camera
    a newspaper
    a post-it
    a safety limiter
  a multitool
  a watch (being worn)

>w
Triage
This is a triage area for the ER to the east.  To the north is the main Hospital lobby, and west lies the automatic doors out to the driveway.  Patients and staff are moving back and forth through the area.

You can go north, east to the Emergency Room, and west through the ER door (closed) to Hospital Driveway from here.

There is a Public Surveillance Notice here.

>n
Hospital Lobby
This is the main entrance to a busy regional hospital. Autodoors lie to the west.  Patients and staff rush back and forth, all too busy to pay you any attention.  To the south is an archway with a sign reading "TRIAGE"; to the east is the elevator core and to the north is the waiting lounge.

You can go north, south to Triage, east, and west through the Hospital door (closed) from here.

There is a Public Surveillance Notice here.

>n
Hospital Lounge
This lounge is full of marginally-comfortable seating and antiquated magazines.  A door to the east reads "LAB" and the main lobby is to the south.  It is deserted; looking at the decor, you're pretty sure you know why.

You can go south to Hospital Lobby and east from here.

>e
Hospital Lab
This is an all-purpose pathology laboratory receiving area.  The lab itself is behind a bulletproof glass wall to the east, and a small window allows samples or paperwork to be passed back and forth.

You can see a cryopack (closed) and a trash can (closed) here.

You can go west to Hospital Lounge from here.

There is a Public Surveillance Notice here.

>take cryopack
Taken.

>w
Hospital Lounge
This lounge is full of marginally-comfortable seating and antiquated magazines.  A door to the east reads "LAB" and the main lobby is to the south.  It is deserted; looking at the decor, you're pretty sure you know why.

You can go south to Hospital Lobby and east to the Hospital Lab from here.

>s
Hospital Lobby
This is the main entrance to a busy regional hospital. Autodoors lie to the west.  Patients and staff rush back and forth, all too busy to pay you any attention.  To the south is an archway with a sign reading "TRIAGE"; to the east is the elevator core and to the north is the waiting lounge.

You can go north to Hospital Lounge, south to Triage, east, and west through the Hospital door (closed) from here.

There is a Public Surveillance Notice here.

>s
Triage
This is a triage area for the ER to the east.  To the north is the main Hospital lobby, and west lies the automatic doors out to the driveway.  Patients and staff are moving back and forth through the area.

You can go north to Hospital Lobby, east to the Emergency Room, and west through the ER door (closed) to Hospital Driveway from here.

There is a Public Surveillance Notice here.

>e
Emergency Room
This is a prep and emergency treatment area for the emergency ward to the east, which is locked.  Triage is to the west, and a door leads north.  The ER is presently unused, and lies empty.

You can see a tissue generator here.

You can go north and west to Triage from here.

There is a Public Surveillance Notice here.

>open cryopack
You open the cryopack. A small cloud of chill and condensation escapes from the cryopack into the surrounding air.  The green LED on it goes out; a red one lights up.

>put cryopack in sample slot
You put the cryopack into the sample slot.

>switch on tissue generator
(the tissue generator)
Lights flash and the machine hums for a while. With a final hiss, the tissue generator lights an indicator reading "COMPLETE."  You notice the cryopack is now closed and operating.

>take cryopack
Taken.

>n
Hospital Elevators
The main elevator bank for the hospital seems to require either an appropriate Mit-Klein scan or a hospital ID to swipe.  Patients and staff move through the area. The lobby is to the west.  The ER is through a door to the south, and a restroom is to the east.

You can go south to the Emergency Room, east, and west to Hospital Lobby from here.

There is a Public Surveillance Notice here.

>e
Hospital Restroom
A clean restroom that smells strongly of disinfectant and hand sanitizer.  There is a single sink with a small mirror over it and a single stall.

You can see a trash can (closed) here.

You can go west to Hospital Elevators from here.

>open solar panel with multitool
You pry open the solar panel with the pliers in your multitool, ignoring the sound of breaking plastic.

Opening the solar panel reveals the broadcast chip!

* * *

>take broadcast
Taken.

>i
You are carrying:
  a broadcast chip
  a cryopack (closed)
  a torn jacket (being worn)
  a receive chip
  a contact lens (being worn)
  a tag remover
  a backpack (being worn, and open)
    a disarmed breaching charge
    a medical camera
    a car key
      a broadcast chip
      a transponder memory chip
    a harness
    a disarmed tear gas grenade
    an ID camera
    a lens case (open but empty)
    a lockblade knife
    a thermos (open)
      three blank memory chips
    a soldering iron
    some solder
    a tablet computer
    a cotter pin
    a pager (open but empty)
    a lost camera
    a newspaper
    a post-it
    a safety limiter
  a multitool
  a watch (being worn)

>w
Hospital Elevators
The main elevator bank for the hospital seems to require either an appropriate Mit-Klein scan or a hospital ID to swipe.  Patients and staff move through the area. The lobby is to the west.  The ER is through a door to the south, and a restroom is to the east.

You can go south to the Emergency Room, east to Hospital Restroom, and west to Hospital Lobby from here.

There is a Public Surveillance Notice here.

>w
Hospital Lobby
This is the main entrance to a busy regional hospital. Autodoors lie to the west.  Patients and staff rush back and forth, all too busy to pay you any attention.  To the south is an archway with a sign reading "TRIAGE"; to the east is the elevator core and to the north is the waiting lounge.

You can go north to Hospital Lounge, south to Triage, east to Hospital Elevators, and west through the Hospital door (closed) from here.

There is a Public Surveillance Notice here.

>w
(first opening the Hospital door)

Hospital Entrance
This is the front entryway pavilion of the local hospital.  The automatic entryway doors are to the east, and the ER entrance and driveway is to the south.

The Reserve Bank Spacescraper is visible in the distance, rising over the low skyline.

You can go south to Hospital Driveway, southwest to Government Square South, east through the Hospital door to Hospital Lobby, and west to Government Square North from here.

There is a Public Surveillance Notice here.

The automatic door slides closed.

>sw
Government Square South
This is the southern half of Government Square.  Several benches and landscape features are scattered throughout the area.  A roadway approaches from the west, loops north around the square and continues to the east.  Groundcars move back and forth along the road, mixed with official vehicles such as police cars, ambulances and the ubiquitous slightly shabby black flitters used by government agencies.  The doors to Green Service Transit station are to the south.  Across the road to the east is Green Hospital's driveway.  The Hospital's main entrance is to the northeast.  The square continues to the north.  To the northwest, across the road on the other side, is the front steps of the local police station.

The Reserve Bank Spacescraper is visible in the distance, rising over the low skyline.

You can go north to Government Square North, northeast to Hospital Entrance, northwest to Police Station Steps, south to Green Service Station, and east to Hospital Driveway from here.

There is a Public Surveillance Notice here.

>s
Green Service Station
Green Service is the local government services cluster.  The Transit station seems to reflect this, exhibiting a weary conformity - although you couldn't say exactly how.  A stairway leads down to the platform access doors, and a set of doorways lead north out onto Government Square.

You can go north to Government Square South and down through the Green Service Station door (closed) to Green Service Platform from here.

There is a Public Surveillance Notice here.

* * *

>wait for capsule
A commuter walks by.

A police officer strolls through the area, giving you a suspicious look before moving on.
Warning lights along the platform edge begin to blink rapidly.  A light grows in the tunnel.  With a deep moan and gust of wind, an express Transit Capsule blasts through Green Service One and vanishes into the darkness once more.

You hear a very quiet beep from somewhere you can't identify.

Warning lights along the platform edge begin to blink rapidly.  A light grows in the tunnel.  With a deep moan and gust of wind, an express Transit Capsule blasts through Green Service One and vanishes into the darkness once more.

A commuter walks by.

A light grows in the tunnel.  With a deep thrumming and the whoosh of displaced air, the Transit Capsule slides smoothly into Green Service Platform and comes to a stop, hovering in the Web.  The doors slide open and a few commuters enter and exit the capsule.
A few commuters get on and off the Transit capsule.

>enter capsule
You move into the Transit Capsule.

Transit Capsule
A fifty-person maglev Transit capsule.  You're standing, holding on to a strap.  Through the windows you can see the Green Service Platform. Several riders share the Capsule with you.

There is a Public Surveillance Notice here.

A few riders get on and off the Transit capsule.

>wait for reserve
A few riders get on and off the Transit capsule.

The capsule doors slide shut.  The humming noice increases in volume, and the capsule slides out of the station, gathering speed as it goes, and slides into the tunnel..

You hold onto your strap as the Capsule rapidly accelerates.

You find yourself mesmerized by an advertisement for disposable cameras.

With a deep thrumming and the whoosh of displaced air, the Transit Capsule slides smoothly into Reserve Bank Station and comes to a stop, hovering in the Web.  The doors slide open and a few commuters enter and exit the capsule.
A few riders get on and off the Transit capsule.

>exit
Reserve Bank Station
The Reserve Bank Transit Station. The platform opens out at the middle to a lobby area which is dominated by a row of automated doors to the west.  The flow of commuters moves steadily through these doors, with each person turning their head to the right as they approach for the eye scanner to verify their identity before opening the portal long enough for them to slip through.  The floor and walls are both clean duramex nanotile, and the station name (Reserve Bank) is indicated on large plaques set into the walls.  At either end of the platform, closed gates guard against any entry into the slideway tunnels. A platform abuts a Transit web, where a Transit capsule can be seen hovering.  The capsule doors are open.

You can see a Transit Map here.

You can go west through the Reserve Bank Station door (closed) from here.

There is a Public Surveillance Notice here.

A few commuters get on and off the Transit capsule.

>w
(first opening the Reserve Bank Station door)
The Eye Scanner scans the iris printed on the contact lens to determine your identity.  The Reserve Bank Security Subroutine determines that "you" have a legitimate reason to enter the Reserve Bank spacescraper, and the doors slide smoothly open.

Station Corridor
The corridor widens as it terminates at the automatic doors to the Reserve Bank Station, which lies to the east.  There is a directory and guide sign on the wall.  Although traffic is overwhelmingly to the west, there are two doors reserved for traffic into the station, indicated by green lightbars overhead, whose access scanners are active.

You can see a directory here.

You can go east through the Reserve Bank Station door to Reserve Bank Station and west from here.

There is a Public Surveillance Notice here.

The automatic door slides closed.

>w
Food Court
The center of the Food Court beneath the Reserve Bank spacescraper is a busy place at all times of the day.  Around the periphery are several food stand franchises, some doing a brisk business.  Dozens of customers are here waiting in line at the food stands, sitting at the dozens of tables in the center, or just passing through from the Reserve Bank Station to the Lift Lobby up a ramp to the west or vice versa.  The floor is made of duramex tiles.

The food stands here are Reserve Bank Bistro Paris, I Have No Mouth, The Sheep Look Up, Tacos Terriff and Apollo's.

You can see a trash can (closed) here.

You can go northwest, east to Station Corridor, and west from here.

There is a Public Surveillance Notice here.

>l customers
You see a middle-aged executive reading from a handheld.

>l Apollo's
Apollo's Coffee is done up in fake Ancient Greek, as befits its name. Plastic busts and columns adorn its facade.  For some reason, there is a silver robotic head behind the counter, mounted on the wall, where a red scanning laser moves monotonously back and forth.

>nw
Maintenance Area
This corner of the food court is drab and uninhabited.  A closed door marked "MAINTENANCE" lurks to the west, and another marked "RESTROOM" to the north.  The floor and walls are scuffed around the door, no doubt from cleaning implements banging against them on their daily travels.

You can go north, southeast to Food Court, and west through the Maintenance Door (closed) from here.

>n
The Food Court Restroom
Bog-standard restroom.  Several stalls offer a minimum of privacy.  A large mirror covers the walls over the sink.

You can see a trash can (closed) here.

You can go south to Maintenance Area from here.

There is a Public Surveillance Notice here.

>s
Maintenance Area
This corner of the food court is drab and uninhabited.  A closed door marked "MAINTENANCE" lurks to the west, and another marked "RESTROOM" to the north.  The floor and walls are scuffed around the door, no doubt from cleaning implements banging against them on their daily travels.

You can go north to The Food Court Restroom, southeast to Food Court, and west through the Maintenance Door (closed) from here.

>se
Food Court
The center of the Food Court beneath the Reserve Bank spacescraper is a busy place at all times of the day.  Around the periphery are several food stand franchises, some doing a brisk business.  Dozens of customers are here waiting in line at the food stands, sitting at the dozens of tables in the center, or just passing through from the Reserve Bank Station to the Lift Lobby up a ramp to the west or vice versa.  The floor is made of duramex tiles.

The food stands here are Reserve Bank Bistro Paris, I Have No Mouth, The Sheep Look Up, Tacos Terriff and Apollo's.

You can see a trash can (closed) here.

You can go northwest to Maintenance Area, east to Station Corridor, and west from here.

There is a Public Surveillance Notice here.

>w
Lift Lobby
The Lift Lobby controls underground access to the Reserve Bank spacescraper, beneath the towers of industry and capital made pillars of money and sin.  Hundreds of people rush to and fro through the lobby on their way into or out of the building.  To the north is a large bank of bouncelifts, their liftfields on and glowing faintly blue behind security gates.  Access to the bouncelifts is controlled by Lift Scanners, set above and to the right of each bouncelift entry.  There is no ceiling; several meters up, the room opens out into the street level lobby above.  There is a railing around the perimeter of the floor above; several people are leaning against or over it, watching the flow of commuters below them and around you.  The Atrium, a wide open area extending at least halfway up the spacescraper, is visible above that. There is no way to reach the street lobby from here other than via the bouncelifts. A shallow ramp leads east down to the Food Court.

You can hear the confused murmur of a large crowd coming from the Atrium above.

You can see a Powered Platform (on which is a spool) and the Security Guard here.

You can go east to Food Court and up from here.

There is a Public Surveillance Notice here.

>enter platform
The security guard looks over, sees your maintenance jacket and gives you a nod.

You get onto the Powered Platform.

On the Powered Platform you can see a spool.

>take spool
Taken.

>attach spool and harness
You fashion the harness and the spool into a descender!

>exit
You get off the Powered Platform.

Lift Lobby
The Lift Lobby controls underground access to the Reserve Bank spacescraper, beneath the towers of industry and capital made pillars of money and sin.  Hundreds of people rush to and fro through the lobby on their way into or out of the building.  To the north is a large bank of bouncelifts, their liftfields on and glowing faintly blue behind security gates.  Access to the bouncelifts is controlled by Lift Scanners, set above and to the right of each bouncelift entry.  There is no ceiling; several meters up, the room opens out into the street level lobby above.  There is a railing around the perimeter of the floor above; several people are leaning against or over it, watching the flow of commuters below them and around you.  The Atrium, a wide open area extending at least halfway up the spacescraper, is visible above that. There is no way to reach the street lobby from here other than via the bouncelifts. A shallow ramp leads east down to the Food Court.

You can hear the confused murmur of a large crowd coming from the Atrium above.

You can see a Powered Platform and the Security Guard here.

You can go east to Food Court and up from here.

There is a Public Surveillance Notice here.

>e
Food Court
The center of the Food Court beneath the Reserve Bank spacescraper is a busy place at all times of the day.  Around the periphery are several food stand franchises, some doing a brisk business.  Dozens of customers are here waiting in line at the food stands, sitting at the dozens of tables in the center, or just passing through from the Reserve Bank Station to the Lift Lobby up a ramp to the west or vice versa.  The floor is made of duramex tiles.

The food stands here are Reserve Bank Bistro Paris, I Have No Mouth, The Sheep Look Up, Tacos Terriff and Apollo's.

You can see a trash can (closed) here.

You can go northwest to Maintenance Area, east to Station Corridor, and west to Lift Lobby from here.

There is a Public Surveillance Notice here.

>nw
Maintenance Area
This corner of the food court is drab and uninhabited.  A closed door marked "MAINTENANCE" lurks to the west, and another marked "RESTROOM" to the north.  The floor and walls are scuffed around the door, no doubt from cleaning implements banging against them on their daily travels.

You can go north to The Food Court Restroom, southeast to Food Court, and west through the Maintenance Door (closed) from here.

>open cryopack
You open the cryopack. A small cloud of chill and condensation escapes from the cryopack into the surrounding air.  The green LED on it goes out; a red one lights up. There is a skin sample inside the cryopack.

>wear sample
Fortunately it's sticky enough to adhere to your palm.

(first taking the skin sample)
You put on the skin sample.

>palm door
(first opening the Maintenance Door)
You press your doctored palm against the scanner.  The lock clicks open.

Utility Closet
The maintenance closet is dimly lit and, ironically, not terribly clean.  There are various cleaning implements and supplies stored on shelves around the walls, a fire equipment wall rack, and a large metal solvents cabinet taking up one wall.  A fluorescent light panel flickers wanly in the ceiling. Two doors lead out of the closet, one east and one west.

On the wall rack are a gas mask and a fire axe.

A scuffed disposable camera with a building property sticker on it is here.  Written on it in marker are the words "DOCUMENT ALL MAINTENANCE ITEMS."

You can go east through the Maintenance Door to Maintenance Area and west from here.

The automatic door slides closed.

>take mask and disposable camera
You can't see any such thing.

>tak mask
That's not a verb I recognize.

>take mask
Homeland Security frowns on people wearing gas masks in public places.  You should exercise caution and not be seen wearing it.

Taken.

>put mask in pack
(the backpack)
You put the gas mask into the backpack.

>take camera
(the maintenance camera)
Taken.

>put maintenance camera in pack
(the backpack)
You put the maintenance camera into the backpack.

>e
(first opening the Maintenance Door)

Maintenance Area
This corner of the food court is drab and uninhabited.  A closed door marked "MAINTENANCE" lurks to the west, and another marked "RESTROOM" to the north.  The floor and walls are scuffed around the door, no doubt from cleaning implements banging against them on their daily travels.

You can go north to The Food Court Restroom, southeast to Food Court, and west through the Maintenance Door to the Utility Closet from here.

The automatic door slides closed.

>se
Food Court
The center of the Food Court beneath the Reserve Bank spacescraper is a busy place at all times of the day.  Around the periphery are several food stand franchises, some doing a brisk business.  Dozens of customers are here waiting in line at the food stands, sitting at the dozens of tables in the center, or just passing through from the Reserve Bank Station to the Lift Lobby up a ramp to the west or vice versa.  The floor is made of duramex tiles.

The food stands here are Reserve Bank Bistro Paris, I Have No Mouth, The Sheep Look Up, Tacos Terriff and Apollo's.

You can see a trash can (closed) here.

You can go northwest to Maintenance Area, east to Station Corridor, and west to Lift Lobby from here.

There is a Public Surveillance Notice here.

>l trash can
Painted industrial dark green, the Food Court trash can awaits its daily diet of rubbish.  There is a solar panel on it; presumably it reports back to a central system when it is full.

>x solar panel
A small (8x8cm) solar panel set into the top, apparently meant to power something embedded in the trash can beneath it.

>drop grenade
You haven't got that.

>i
You are carrying:
  a skin sample (being worn)
  a broadcast chip
  a cryopack (open but empty)
  a torn jacket (being worn)
  a receive chip
  a contact lens (being worn)
  a tag remover
  a backpack (being worn, and open)
    a maintenance camera
    a gas mask
    a descender
    a disarmed breaching charge
    a medical camera
    a car key
      a broadcast chip
      a transponder memory chip
    a disarmed tear gas grenade
    an ID camera
    a lens case (open but empty)
    a lockblade knife
    a thermos (open)
      three blank memory chips
    a soldering iron
    some solder
    a tablet computer
    a cotter pin
    a pager (open but empty)
    a lost camera
    a newspaper
    a post-it
    a safety limiter
  a multitool
  a watch (being worn)

>take grenade
Taken.

>arm grenade
You pull the pin on the tear gas grenade and drop it as it begins to hiss!

>wear gas mask
(first taking the gas mask)
You put on the gas mask.

Policemen rush into the area and grab you.  Wearing gas masks in public is against Homeland Security regulations!

    *** You have been arrested! ***

Would you like to RESTART, RESTORE a saved game, QUIT, or UNDO the last command?

>undo
Food Court
[Previous turn undone.]

I didn't catch that.

>z
Time passes.

With a bang and an enormous hiss, the gas grenade goes off and fills the area with a cloud of opaque smoke and tear gas!

>wear mask
(first taking the gas mask)
You put on the gas mask.

Billowing clouds of tear gas and smoke make it difficult to see.  You can hear screams and crashing as people around you try to flee.

>open solar panel with multitool
You pry open the solar panel with the pliers in your multitool, ignoring the sound of breaking plastic.

Opening the solar panel reveals the broadcast chip!

Billowing clouds of tear gas and smoke make it difficult to see.  You can hear screams and crashing as people around you try to flee.

>take broadcast
Taken.

>nw
Maintenance Area
This corner of the food court is drab and uninhabited.  A closed door marked "MAINTENANCE" lurks to the west, and another marked "RESTROOM" to the north.  The floor and walls are scuffed around the door, no doubt from cleaning implements banging against them on their daily travels.

You can go north to The Food Court Restroom, southeast to Food Court, and west through the Maintenance Door (closed) to the Utility Closet from here.

>w
(first opening the Maintenance Door)
You press your doctored palm against the scanner.  The lock clicks open.

Utility Closet
The maintenance closet is dimly lit and, ironically, not terribly clean.  There are various cleaning implements and supplies stored on shelves around the walls, a fire equipment wall rack, and a large metal solvents cabinet taking up one wall.  A fluorescent light panel flickers wanly in the ceiling. Two doors lead out of the closet, one east and one west.

On the wall rack is a fire axe.

You can go east through the Maintenance Door to Maintenance Area and west from here.

The automatic door slides closed.

>remove mask
You take off the gas mask.

>drop mask
Dropped.

>open maintenance camera with tool
Taken.

You pry open the maintenance camera with the pliers in your multitool, ignoring the sound of breaking plastic.

>open lost camera with tool
Taken.

You pry open the lost camera with the pliers in your multitool, ignoring the sound of breaking plastic.

>open medical camera with tool
Taken.

You pry open the medical camera with the pliers in your multitool, ignoring the sound of breaking plastic.

>put memory in chipslot
Which do you mean, the transponder memory chip or a blank memory chip?

>put blank memory chip in chipslot
The Download light flashes red intermittently for a few seconds before returning to a regular blinking green.

>take attack chip
Taken.

>put blank memory chip in chipslot
The Download light flashes red intermittently for a few seconds before returning to a regular blinking green.

>take attack chip
(putting the multitool into the backpack to make room)
Taken.

>put blank memory chip in chipslot
The Download light flashes red intermittently for a few seconds before returning to a regular blinking green.

>take attack chip
(putting the tag remover into the backpack to make room)
Taken.

>i
You are carrying:
  three attack memory chips
  a medical camera
  a lost camera
  a maintenance camera
  two broadcast chips
  a skin sample (being worn)
  a cryopack (open but empty)
  a torn jacket (being worn)
  a receive chip
  a contact lens (being worn)
  a backpack (being worn, and open)
    a tag remover
    a multitool
    a descender
    a disarmed breaching charge
    a car key
      a broadcast chip
      a transponder memory chip
    an ID camera
    a lens case (open but empty)
    a lockblade knife
    a thermos (open but empty)
    a soldering iron
    some solder
    a tablet computer
    a cotter pin
    a pager (open but empty)
    a newspaper
    a post-it
    a safety limiter
  a watch (being worn)

>put cryopack and receive chip in pack
(the backpack)
cryopack: Done.
receive chip: Done.

>solder attack to broadcast
(taking the soldering iron)
Taken.

(taking the solder)
Taken.

You fashion the attack memory chip and the broadcast chip into a Klein Blaster!

>g
You fashion the attack memory chip and the broadcast chip into a Klein Blaster!

>take transponder chip
Taken.

>solder attack to broadcast
You fashion the attack memory chip and the broadcast chip into a Klein Blaster!

>combine klein blaster and medical camera
You fashion the Klein Blaster and the medical camera into a disarmed ID bomb!

>combine klein blaster and lost camera
You fashion the Klein Blaster and the lost camera into a disarmed ID bomb!

>combine klein blaster and maintenance camera
You fashion the Klein Blaster and the maintenance camera into a disarmed ID bomb!

>i
You are carrying:
  three disarmed ID bombs
  a transponder memory chip
  some solder
  a soldering iron
  a skin sample (being worn)
  a torn jacket (being worn)
  a contact lens (being worn)
  a backpack (being worn, and open)
    a receive chip
    a cryopack (open but empty)
    a tag remover
    a multitool
    a descender
    a disarmed breaching charge
    a car key
    an ID camera
    a lens case (open but empty)
    a lockblade knife
    a thermos (open but empty)
    a tablet computer
    a cotter pin
    a pager (open but empty)
    a newspaper
    a post-it
    a safety limiter
  a watch (being worn)

>put solder and iron in pack
(the backpack)
solder: Done.
soldering iron: Done.

>take axe
This axe is large enough to run afoul of local weapons laws.  It would be a bad idea to let it be seen where the police are watching.

>w
Maintenance Corridor
This is the middle of a short corridor running north to south.  The walls are gray-painted cinderblocks and have many scuff marks and scars.  The floor is an industrial non-slip surfaced concrete.  A door to the east is marked "STORAGE."

You can go north, south, and east to the Utility Closet from here.

>s
South End of Maintenance Corridor
The corridor extends to the north from here.  To the west is a service bouncelift.

You can go north to Maintenance Corridor and west from here.

>w
The weight on your feet lightens as the bouncelift field grabs you.

Bottom of Service Bouncelift
Inside the Service Bouncelift, the blue glow of the liftfield illuminates the two-meter cylinder and suspends you just off the floor.  Here at the bottom, there is an exit to the east.

You can go east to South End of Maintenance Corridor and up from here.

>u
You move to the up half of the cylinder and the liftfield wafts you upwards.  This service bouncelift has no intervening exits, so you are in the lift for some time before the top end comes into sight.

Top of Service Bouncelift
You are floating gently in midar at the top of the Service Bouncelift, there is an exit to the east.

You can go east and down to Bottom of Service Bouncelift from here.

>e
You angle yourself towards the door.  The liftfield gently moves you to the edge of the tube, and you swing yourself out of the lift via the safety handle.

Bouncelift Vestibule
The service bouncelift opens onto a small vestibule, not much larger than the size of a closet.  A sign painted on the wall reads "LEVEL 35 - MEZZANINE". There is a door with a palm lock to the east.

You can go east through Vestibule Door (closed) and west to Top of Service Bouncelift from here.

>x lock
A retrofitted palm lock which juts out from the door's surface.

>axe lock
What do you want to axe Vestibule Door lock with?

>axe lock with axe
You heft the axe and set to.  The lock gives way before your furious assault!

>drop axe
Dropped.

>e
(first opening Vestibule Door)

Office Corridor
You are in the middle of a nondescript office corridor.  To the west is a security door to the service bouncelift.  To the north is a door reading "RESTROOM".  The corridor continues to the east.

You can go north, east, and west through Vestibule Door to Bouncelift Vestibule from here.

There is a Public Surveillance Notice here.

>e
Seating Area
The corridor ends in a small open seating area.  There is a door leading north, presumably to the rest of the office space.  It is closed and locked.  An observation window looks out east onto a ledge over the spacescraper's hollow core.

You can go west to Office Corridor from here.

There is a Public Surveillance Notice here.

>put breaching charge on window
(first taking the disarmed breaching charge)

You put the disarmed breaching charge on the observation window.

>arm breaching charge
You pull the arming tab out and drop it, arming the Breaching Charge.
As soon as the charge detonates, the police will be looking at the surveillance video from this location; they'll ID you within a few minutes!

>w
Office Corridor
You are in the middle of a nondescript office corridor.  To the west is a security door to the service bouncelift.  To the north is a door reading "RESTROOM".  The corridor continues to the east.

You can go north, east to Seating Area, and west through Vestibule Door to Bouncelift Vestibule from here.

There is a Public Surveillance Notice here.

>n
Office Restroom
This is a restroom.  Since it is within corporate space, it is decorated a notch above most public restrooms, with the walls of the stall still bright white.  You still wouldn't eat off the floor, though.  Also, unlike most public restrooms, it seems to be under surveillance.  You're gratified to see that even this restroom doesn't seem to be safe despite that - a small graffito lurks on the left side of the mirror over the sink.

You can see a trash can (closed) here.

You can go south to Office Corridor from here.

There is a Public Surveillance Notice here.

>wear descender
(first taking the descender)
You put on the descender.

>z
Time passes.

There is an explosion from some distance off!

>s
Office Corridor
You are in the middle of a nondescript office corridor.  To the west is a security door to the service bouncelift.  To the north is a door reading "RESTROOM".  The corridor continues to the east.

You can go north to Office Restroom, east to Seating Area, and west through Vestibule Door to Bouncelift Vestibule from here.

There is a Public Surveillance Notice here.

>e
Seating Area
The corridor ends in a small open seating area.  There is a door leading north, presumably to the rest of the office space.  It is closed and locked.  The wreckage of an observation window leads east out to a ledge.

There are the unmistakable signs of a blast.  Scarring and burn marks are everywhere, and a choking smell of explosives residues hangs in the air.

You can go east and west to Office Corridor from here.

There is a Public Surveillance Notice here.

>e
You step gingerly through the jagged hole in the observation window onto the ledge.

Atrium Ledge
This ledge, along with the others at the Mezzanine level, looks out over the huge hollow core of the Reserve Bank spacescraper's lower third.  The central column containing the main bouncelifts is visible perhaps fifty meters away.   Above, the roof of the atrium is hazily visible through the glare from its light fixtures some thirty floors up.  Thirty floors below, the main lobby can be made out.  To one side of the bouncelift column, the sublevel Lift Lobby can be seen one level below.  A very low glass wall surrounds the ledge for safety, but it's clear that this space isn't meant for the public.  There are a few holes in the plascrete floor where plants once rested; one large planter in the center holds a scarred but defiantly unbent tree.

You're pretty sure the police are looking for you now for setting off that explosive.

>attach cable to tree
You pass the cable around the tree and snap the carabiner on the end around it, firmly attaching the cable to the tree.

>d
You carefully ease yourself over the edge, and before you can think better of it you let go!  The descender slowly pays out cable with a steady whir, and you find yourself dropping through empty space!

The Atrium (Midair)
You are hanging in empty space some ways down from the ledge, the cable attached to your harness holding you face-down.  Below you you can see the crowds of people at the convention gathered on the Atrium floor.

>arm id bomb
You arm the bomb and toss it. The bomb spins down out of sight towards a window wall.  A few seconds later you make out a slight twinkling as the flash unit fires.  A low noise, of a crowd confused, slowly rises in volume!

The descender whirs steadily as it lowers you.

The Atrium (Midair)
You are hanging in empty space some ways down from the ledge, the cable attached to your harness holding you face-down.  Below you you can see the crowds of people at the convention gathered on the Atrium floor.

>g
Arming another bomb, you toss it away into the atrium where crowds are gathering at the windows!  The bomb flashes just in front of a large crowd gathered before a window wall, and they begin to mill about in panic and confusion!  The noise inside the atrium rises!

The descender whirs steadily as it lowers you.

The Atrium (Midair)
You are perhaps halfway down the atrium now.  You can make out individual people in the crowd of Homeland Security conventioneers below you.  People are coming to the windows all around the atrium now as word of your descent spreads.

>g
You arm your third ID bomb and drop it directly down into the crowds in the Main Lobby, where you can see police and Homeland Security forces pointing up at you as they maneuver into place.  There is a definite flinching in the crowd as the bomb goes off nearly at floor level, and the law enforcement personnel are instantly swamped by the confused masses of convention attendees as everyone on the Lobby floor is cut off from communicating directly with their electronics!

The descender whirs steadily as it lowers you.

The Atrium (Midair)
You are nearly to the bottom.  The crowd below you has seen you, and a few people are pointing up.

>z
Time passes.

The descender whirs steadily as it lowers you.

Main Lobby
This is the floor level of the main lobby, at the bottom of the tower atrium.

You can go up to the The Atrium (Midair) and down to Lift Lobby from here.

You reach the floor of the Main Lobby.  The confusion is immense, as thousands of people realize that their MitKlein bottles no longer function.  The various law enforcement personnel throughout the crowd are distracted and paralyzed by the fact that their equipment will no longer recognize them.  In the confusion, your landing goes nearly unnoticed.  You slip out of the descender and it whisks back upwards out of sight.

Soon, new police enter the lobby and begin organizing an evacuation while others continue their futile search for the unknown attacker.  A policeman gestures at you and a group of people near you to follow him and turns to head downstairs towards the Transit station.

Moving away, you head for the lift tube to the roof pads and your extraction point.  You cast a glance over as everyone else in the area turns to follow the policeman, and you feel the savage grin on your face.

Meek and obedient, you follow the leader down well-trodden corridors, down into the Valley of Steel. But the police can't save you.  I can.  I will.  I'm coming back.  I'm coming for all of you.

    *** You are free! ***

Would you like to RESTART, RESTORE a saved game, QUIT, or UNDO the last command?

* * *

>e
(first opening the Green Residential Station door)
The Eye Scanner laser delicately probes your iris, and the doors slide smoothly open.

Green Residential Station
This is a utilitarian shelter intended mostly to keep the rain out of the Transit System.  A stairway leads down to the autodoor leading to the Transit platform and an exit leads east to the street.

You can go east to Primrose & Station and down through the Green Residential Station door to Green Residential Platform from here.

There is a Public Surveillance Notice here.

The automatic door slides closed.