Welcome to the future.  Every citizen has been scanned, chipped, folded, spindled and mutilated - and it's enough to make you scream.

Valley of Steel
A tale of the surveillance society by The Custodian of http://everything2.com
Release 1 / Serial number 130328 / Inform 7 build 6G60 (I6/v6.32 lib 6/12N) SD

Bedroom
Your bedroom is rather boring, indicative of how little time you spend in it while awake.  It contains your bed - currently, as always, unmade - and a bedside table with a lamp on it.

On the bedside table are a watch and a phone.

You can go north and west from here.

>gonear jukebox
The Proletariat Bar
The Proletariat is a local bar (not a pub).  It's just far enough above a "dive" to be allowed zoning here, but steadfastedly refuses to cater to upscale tastes.  You like it.  Restrooms are to the east; the bar runs along the north side, a jukebox sits against the back wall, and the rest of the space is filled with bar tables.  A few hardy drinkers sit here, communing with their spirits.  In a nod to the place's name, a Public Surveillance Notice covered with stickers and graffiti tags has been framed above the bar.

You can go northwest, southwest, east and west from here.

* * *

Welcome to the future.  Every citizen has been scanned, chipped, folded, spindled and mutilated - and it's enough to make you scream.

Valley of Steel
A tale of the surveillance society by The Custodian of http://everything2.com
Release 1 / Serial number 130328 / Inform 7 build 6G60 (I6/v6.32 lib 6/12N) SD

Bedroom
Your bedroom is rather boring, indicative of how little time you spend in it while awake.  It contains your bed - currently, as always, unmade - and a bedside table with a lamp on it.

On the bedside table are a watch and a phone.

You can go north and west from here.

>gonear accessorize
Accessorize
This well-lit store purveys all manner of cosmetic aids and fashion accessories.  Everything from wrist bangles to skin creams to custom cosmetic contacts can be purchased here.

You can see a Lens Crafter here.

You can go northwest and west from here.

>push crema
You can't see any such thing.

>push cream
As you reach for it, the store's systems detect your lack of functioning MitKlein bottle.  A bright red light flashes and a buzzer sounds.  You quickly retract your hand.

>push creams
You can't see any such thing.

>buy cream
As you reach for it, the store's systems detect your lack of functioning MitKlein bottle.  A bright red light flashes and a buzzer sounds.  You quickly retract your hand.

>w
Green Commercial Plaza South
The southern end of the Green Commercial Plaza, which continues to the north.  To the east is Accessorize, a fashion store, and to the west is Garb-oh, a trendy clothing shop.  The south end of the mall is closed off by an elaborate landscaping installation of trees and shrubs, presumably to hide a relatively ugly building behind it.

The Reserve Bank Spacescraper is visible in the distance, rising over the low skyline.

You can also see a trash can (closed) here.

You can go north, northeast, northwest, east to Accessorize and west through the Garb-oh door (closed) from here.

There is a Public Surveillance Notice here.

>w
(first opening the Garb-oh door)

Garb-oh
Garb-oh! is a trendy clothing shop.  Images of the shop's icon Greta Garbo abound, each dressed in the clothing item offered on the rack below it.  Jackets, scarves, bandannas, trousers, shirts and more are on inviting display.

On the racks are a blue jacket, a red jacket, a white shirt, a green shirt, a blue pair of pants and a brown pair of pants.

The sales counter runs along the north side of the store.

You can also see the shopkeeper and the shopper here.

You can go east through the Garb-oh door to Green Commercial Plaza South from here.

There is a Public Surveillance Notice here.

The automatic door slides closed.

>l racks
Garb-oh has the latest in shiny, innocuous chromed clothing racks.

On the racks are a blue jacket, a red jacket, a white shirt, a green shirt, a blue pair of pants and a brown pair of pants.

>take racks
That's hardly portable.

* * *

Welcome to the future.  Every citizen has been scanned, chipped, folded, spindled and mutilated - and it's enough to make you scream.

Valley of Steel
A tale of the surveillance society by The Custodian of http://everything2.com
Release 1 / Serial number 130328 / Inform 7 build 6G60 (I6/v6.32 lib 6/12N) SD

Bedroom
Your bedroom is rather boring, indicative of how little time you spend in it while awake.  It contains your bed - currently, as always, unmade - and a bedside table with a lamp on it.

On the bedside table are a watch and a phone.

You can go north and west from here.

>take phone
Taken.

* * *

Welcome to the future.  Every citizen has been scanned, chipped, folded, spindled and mutilated - and it's enough to make you scream.

Valley of Steel
A tale of the surveillance society by The Custodian of http://everything2.com
Release 1 / Serial number 130328 / Inform 7 build 6G60 (I6/v6.32 lib 6/12N) SD

Bedroom
Your bedroom is rather boring, indicative of how little time you spend in it while awake.  It contains your bed - currently, as always, unmade - and a bedside table with a lamp on it.

On the bedside table are a watch and a phone.

You can go north and west from here.

>gonear hard bench
Booking
This area is used for processing prisoners…er, excuse me, suspects, and as a waiting lounge.  There is a single hard bench, now empty, and a counter along the south wall with a stern poster on the wall above it.  One area has been kept clear and is a neutral pale blue, presumably to be used as a backdrop for photographing suspects.

You can see an ID camera here.

You can go north from here.

>sit
(on the backpack)
That's not something you can sit down on.

>sit on bench
That's not something you can sit down on.

>sit on hard bench
That's not something you can sit down on.

* * *

>gonear hard bench
Booking
This area is used for processing prisoners…er, excuse me, suspects, and as a waiting lounge.  There is a single hard bench, now empty, and a counter along the south wall with a stern poster on the wall above it.  One area has been kept clear and is a neutral pale blue, presumably to be used as a backdrop for photographing suspects.

You can see an ID camera here.

You can go north from here.

>sit on bench
You sit down on the hard bench.  It gives not a millimeter.

>gonear bench
(the hard bench)
Booking
This area is used for processing prisoners…er, excuse me, suspects, and as a waiting lounge.  There is a single hard bench, now empty, and a counter along the south wall with a stern poster on the wall above it.  One area has been kept clear and is a neutral pale blue, presumably to be used as a backdrop for photographing suspects.

You can see an ID camera here.

You can go north from here.

>gonear fountain
Green Commercial Plaza Center
This is the center of the Green Commercial Plaza.  There is a fountain here with a bench facing it.  The plaza continues to the north and south; to the east is a bar called (ironically, you hope) the Proletariat.  To the west is a Bistro Paris cafe.

The Reserve Bank Spacescraper is visible in the distance, rising over the low skyline.

You can also see a trash can (closed) here.

You can go north, northeast, northwest, south, southeast, east and west from here.

>sit on bench
You sit down on the bench.

>gonear hard bench
Booking
This area is used for processing prisoners…er, excuse me, suspects, and as a waiting lounge.  There is a single hard bench, now empty, and a counter along the south wall with a stern poster on the wall above it.  One area has been kept clear and is a neutral pale blue, presumably to be used as a backdrop for photographing suspects.

You can see an ID camera here.

You can go north from here.

* * *

>sit on bench
You sit down on the hard bench.  It gives not a millimeter.

>showme me
yourself - person
    your palm (part of yourself) - palm
    your eye (part of yourself) - eye
    MitKlein (part of yourself)
    backpack (worn) - player's holdall
location: on the hard bench in Booking
singular-named, proper-named; unlit, inedible, portable, assembled; male, unbriefed
printed name: "yourself"
printed plural name: "people"
indefinite article: none
description: "As good-looking as ever."
initial appearance: none
size: medium
carrying capacity: 5
suspicionState: clear

>n
(first getting off the hard bench)

Front Desk
This is the front desk of the police station. A harried sergeant is manning the desk, and are so busy they don't even have time to give you more than a brief scowl.  To the north is a security gate leading into the police station proper, and to the south is an open area with a sign reading "BOOKING."

You can see Sergeant Ramirez here.

You can go south to Booking and east from here.

There is a Public Surveillance Notice here.

The door swings open and two officers come in, manhandling a suspect between them.  Ignoring their suspect's complaints, they pause briefly to check in with the desk before moving on into the police station.

>e
Police Station Steps
These are the busy steps of the local police station.  To the east and southeast is Government Square, while the police station lies at the top to the west. Uniformed police and people in plain clothes are traversing the steps to exit and enter the building.

The Reserve Bank Spacescraper is visible in the distance, rising over the low skyline.

You can go southeast, east and west to the Front Desk from here.

There is a Public Surveillance Notice here.

>se
Government Square South
This is the southern half of Government Square.  Several benches and landscape features are scattered throughout the area.  A roadway approaches from the west, loops north around the square and continues to the east.  Groundcars move back and forth along the road, mixed with official vehicles such as police cars, ambulances and the ubiquitous slightly shabby black flitters used by government agencies.  The doors to Green Service Transit station are to the south.  Across the road to the east is Green Hospital's driveway.  The Hospital's main entrance is to the northeast.  The square continues to the north.  To the northwest, across the road on the other side, is the front steps of the local police station.

The Reserve Bank Spacescraper is visible in the distance, rising over the low skyline.

You can go north, northeast, northwest to Police Station Steps, south and east from here.

There is a Public Surveillance Notice here.

>e
Hospital Driveway
The driveway and parking area for the Hospital ER, which lies directly to the east.  To the north is the main entrance to the Hospital building.

The Reserve Bank Spacescraper is visible in the distance, rising over the low skyline.

An ambulance, a bulky flittervan with emergency markings, is parked here.

You can go north, northwest, east through the ER door (closed) and west to Government Square South from here.

There is a Public Surveillance Notice here.

>x ambulance
This aerovan is probably a Geely-Ford/Fujiwara product underneath, but has all manner of emergency lights and markings on it, including a large set of red crosses.  It has a double door in the back along with the two main cab entry doors.  It is dark and powered down but securely locked, and a slowly blinking light indicates that its locklarm is armed.

>open cab
You can't see any such thing.

>open ambulance
As you reach for the door handle, the locklarm begins to strobe and an ominous beeping begins.  You decide not to risk it.

>l
Hospital Driveway
The driveway and parking area for the Hospital ER, which lies directly to the east.  To the north is the main entrance to the Hospital building.

The Reserve Bank Spacescraper is visible in the distance, rising over the low skyline.

An ambulance, a bulky flittervan with emergency markings, is parked here.

You can go north, northwest, east through the ER door (closed) and west to Government Square South from here.

There is a Public Surveillance Notice here.

>e
(first opening the ER door)

Triage
This is a triage area for the ER to the east.  To the north is the main Hospital lobby, and west lies the automatic doors out to the driveway.

You can go north, east and west through the ER door to Hospital Driveway from here.

There is a Public Surveillance Notice here.

The automatic door slides closed.

>e
Emergency Room
This is a prep and emergency treatment area for the emergency ward to the east, which is locked.  Triage is to the west, and a door leads north.

You can see a tissue generator here.

You can go north and west to Triage from here.

There is a Public Surveillance Notice here.

>x generator
(the tissue generator)
This is a medium-sized appliance found in most modern hospitals.  It is used to provide artificial tissue for grafting into or onto injuries.  In order to prevent rejection, the tissue generator must be given a complete scan of the patient's tissue, from which it will (by default) produce an exact duplicate of the scanned sample.  It has a button marked ACTIVATE. There is a slot on the front of the machine labeled "INSERT CRYOPACK FOR SAMPLE" where, presumably, the generated tissue is delivered; there is a smaller opening labeled "FEED" and there is a slot labeled "READ" where a tissue sampler can be inserted.    The feed slot contains biogen feedstock.

The tissue generator is currently switched off.

>e
You can't go that way.

>w
Triage
This is a triage area for the ER to the east.  To the north is the main Hospital lobby, and west lies the automatic doors out to the driveway.

You can go north, east to the Emergency Room and west through the ER door (closed) to Hospital Driveway from here.

There is a Public Surveillance Notice here.

>e
Emergency Room
This is a prep and emergency treatment area for the emergency ward to the east, which is locked.  Triage is to the west, and a door leads north.

You can see a tissue generator here.

You can go north and west to Triage from here.

There is a Public Surveillance Notice here.

>turn on generator
(the tissue generator)
The tissue generator blinks a red indicator which reads NOT READY: CHECK SLOTS and deactivates.

>w
Triage
This is a triage area for the ER to the east.  To the north is the main Hospital lobby, and west lies the automatic doors out to the driveway.

You can go north, east to the Emergency Room and west through the ER door (closed) to Hospital Driveway from here.

There is a Public Surveillance Notice here.

>gonear reserve bank platform
There seems to be no such object anywhere in the model world.

>gonear reserve bank station
(Reserve Bank Station)
Reserve Bank Station
The Reserve Bank Transit Station. The platform opens out at the middle to a lobby area which is dominated by a row of automated doors to the west.  The flow of commuters moves steadily through these doors, with each person turning their head to the right as they approach for the eye scanner to verify their identity before opening the portal long enough for them to slip through.  The floor and walls are both clean duramex nanotile, and the station name (Reserve Bank) is indicated on large plaques set into the walls.  At either end of the platform, closed gates guard against any entry into the slideway tunnels. A platform abuts a Transit web, now empty.

You can go west through the Reserve Bank Station door (closed) from here.

>w
(first opening the Reserve Bank Station door)
The Eye Scanner laser delicately probes your iris to determine your identity.  The Reserve Bank Security Subroutine determines that you have no legitimate reason to enter the Reserve Bank spacescraper.  A harsh buzzer sounds and the door remains locked.

>w
(first opening the Reserve Bank Station door)
The Eye Scanner laser delicately probes your iris to determine your identity.  The Reserve Bank Security Subroutine determines that you have no legitimate reason to enter the Reserve Bank spacescraper.  A harsh buzzer sounds and the door remains locked.

>gonear food court
Which do you mean, Food Court, the Food Court Restroom Door, Food Court Restroom, the Food Court Restroom mirror or the Food Court Restroom mirror's doodle?

>gonear tacos terrif
I only understood you as far as wanting to gonear Tacos Terriff.

>gonear taco terrif
There seems to be no such object anywhere in the model world.

>gonear tacos terriff
Tacos Terriff
Tacos Terriff is a bare-bones Mexicalitexazonan food joint.  Meat product is scooped into grain-plastic shells and covered with various unidentifiable industrial sauces and shredded veggies.  Despite this, it seems to have a dedicated following, as it is doing land-office business with the lunch set.

You can go north, east and west from here.

>but taco
That's not a verb I recognize.

>buy taco
You can't see any such thing.

>e
The Sheep Look Up
The Sheep Look Up is a gyros restaurant, featuring small cartoon sheep heads looking imploringly up from the steam table behind the glass.  Two surly employees are hard at work slicing gyros and constructing sandwiches and lunch platters for the several dozen hungry customers who wait in line.

You can go north, northwest and west to Tacos Terriff from here.

There is a Public Surveillance Notice here.

* * *

Welcome to the future.  Every citizen has been scanned, chipped, folded, spindled and mutilated - and it's enough to make you scream.

Valley of Steel
A tale of the surveillance society by The Custodian of http://everything2.com
Release 1 / Serial number 130328 / Inform 7 build 6G60 (I6/v6.32 lib 6/12N) SD

Bedroom
Your bedroom is rather boring, indicative of how little time you spend in it while awake.  It contains your bed - currently, as always, unmade - and a bedside table with a lamp on it.

On the bedside table are a watch and a phone.

You can go north and west from here.

>purloin blue jacket and tag remover and knife
[Purloined.]
[Purloined.]
[Purloined.]

* * *

Welcome to the future.  Every citizen has been scanned, chipped, folded, spindled and mutilated - and it's enough to make you scream.

Valley of Steel
A tale of the surveillance society by The Custodian of http://everything2.com
Release 1 / Serial number 130328 / Inform 7 build 6G60 (I6/v6.32 lib 6/12N) SD

Bedroom
Your bedroom is rather boring, indicative of how little time you spend in it while awake.  It contains your bed - currently, as always, unmade - and a bedside table with a lamp on it.

On the bedside table are a watch and a phone.

You can go north and west from here.

>gonear scarred tree
Atrium Ledge
This ledge, along with the others at the Mezzanine level, looks out over the huge hollow core of the Reserve Bank spacescraper's lower third.  The central column containing the main bouncelifts is visible perhaps fifty meters away.   Above, the roof of the atrium is hazily visible through the glare from its light fixtures some thirty floors up.  Sixty floors below, the main lobby can be made out.  To one side of the bouncelift column, the sublevel Lift Lobby can be seen one level below the lobby.  A very low glass wall surrounds the ledge for safety, but it's clear that this space isn't meant for the public.  There are a few holes in the plascrete floor where plants once rested; one large planter in the center holds a scarred but defiantly unbent tree.

>l holes
The ledge's floor is a plascrete surface with several shallow holes in it which once held decorative plants.

>take holes
That would be a neat trick.

>move holes
That would be a neat trick.

>l floor
The ledge's floor is a plascrete surface with several shallow holes in it which once held decorative plants.

* * *

Welcome to the future.  Every citizen has been scanned, chipped, folded, spindled and mutilated - and it's enough to make you scream.

Valley of Steel
A tale of the surveillance society by The Custodian of http://everything2.com
Release 1 / Serial number 130328 / Inform 7 build 6G60 (I6/v6.32 lib 6/12N) SD

Bedroom
Your bedroom is rather boring, indicative of how little time you spend in it while awake.  It contains your bed - currently, as always, unmade - and a bedside table with a lamp on it.

On the bedside table are a watch and a phone.

You can go north and west from here.

>gonear the sheep look up
The Sheep Look Up
The Sheep Look Up is a gyros restaurant, featuring small cartoon sheep heads looking imploringly up from the steam table behind the glass.  Two surly employees are hard at work slicing gyros and constructing sandwiches and lunch platters for the several dozen hungry customers who wait in line.

You can go north, northwest and west from here.

>l employees
(the employees)
Two surly-looking men in stained aprons wearing hairnets, who are busily assembling gyros behind the counter.

>employees, tell me about gyros
There is no reply.

>customers, help
[That command asks to do something outside of play, so it can only make sense from you to me. The customers cannot be asked to do this.]

>customers, who are you
There is no reply.

>customers, tell me about yourselves.
There is no reply.

>rules
Rules tracing now switched on. Type "rules off" to switch it off again, or "rules all" to include even rules which do not apply.

>customers, tell me about yourselves.
[Rule "block asking rule" applies.]
There is no reply.

[Rule "Every Turn during Transit Stop" applies.]

* * *

Welcome to the future.  Every citizen has been scanned, chipped, folded, spindled and mutilated - and it's enough to make you scream.

Valley of Steel
A tale of the surveillance society by The Custodian of http://everything2.com
Release 1 / Serial number 130328 / Inform 7 build 6G60 (I6/v6.32 lib 6/12N) SD

Bedroom
Your bedroom is rather boring, indicative of how little time you spend in it while awake.  It contains your bed - currently, as always, unmade - and a bedside table with a lamp on it.

On the bedside table are a watch and a phone.

You can go north and west from here.

>gonear ramirez
Front Desk
This is the front desk of the police station. A harried sergeant is manning the desk, and are so busy they don't even have time to give you more than a brief scowl.  To the north is a security gate leading into the police station proper, and to the south is an open area with a sign reading "BOOKING."

You can see Sergeant Ramirez here.

You can go south and east from here.

>unlock gate
(with the backpack)
You don't have the key.

>unlock security gate with backpack
You don't have the key.

>open gate
The gate is securely locked.

>s
Booking
This area is used for processing prisoners…er, excuse me, suspects, and as a waiting lounge.  There is a single hard bench, now empty, and a counter along the south wall with a stern poster on the wall above it.  One area has been kept clear and is a neutral pale blue, presumably to be used as a backdrop for photographing suspects.

You can see an ID camera here.

You can go north to the Front Desk from here.

There is a Public Surveillance Notice here.

>sit on bench
You can't see any such thing.

* * *

>gonear ramirez
Front Desk
This is the front desk of the police station. A harried sergeant is manning the desk, and are so busy they don't even have time to give you more than a brief scowl.  To the north is a security gate leading into the police station proper, and to the south is an open area with a sign reading "BOOKING."

You can see Sergeant Ramirez here.

You can go south and east from here.

>unlock security gate
(with the backpack)
The telephone rings.  Sergeant Ramirez answers gruffly, speaks a few words and hangs up.

>rules
Rules tracing now switched on. Type "rules off" to switch it off again, or "rules all" to include even rules which do not apply.

>unlock security gate
(with the backpack)
[Rule "Every turn when the player can see Sergeant Ramirez" applies.]
[Rule "scene description text rule" applies.]

>restart
Are you sure you want to restart?

>yes
Welcome to the future.  Every citizen has been scanned, chipped, folded, spindled and mutilated - and it's enough to make you scream.

Valley of Steel
A tale of the surveillance society by The Custodian of http://everything2.com
Release 1 / Serial number 130326 / Inform 7 build 6G60 (I6/v6.32 lib 6/12N) SD

Bedroom
Your bedroom is rather boring, indicative of how little time you spend in it while awake.  It contains your bed - currently, as always, unmade - and a bedside table with a lamp on it.

On the bedside table are a watch and a phone.

You can go north and west from here.

>w
Hall
The central hallway of your modest home.  It's relatively clean and neat, as there is no furniture in it.

You can go north, east to the Bedroom and west from here.

>n
Entry
This is the small entryway to your apartment. A pile of mail, most of it unread, nearly covers the side table just inside your front door.  The apartment hallway is to the south.  To the west is your office, and to the east is your bathroom.

You can see a side table (on which is a car key) here.

You can go north through the Front door (closed), south to Hall, east and west from here.

>n
(first opening the Front door)
You permit the apartment door scanner to scan your eye.

Home Lobby
The slightly shabby front lobby of your building.  A door leads outside to the west, gated stairs leading up to the upper two floors are to the east, and your apartment door is to the south.

You can go south through the Front door to Entry and west through the House door (closed) from here.

The automatic door slides closed.

>unlock gate
(with the backpack)
You can't open the gate, even with that.

* * *

>gonear ramirez
Front Desk
This is the front desk of the police station. A harried sergeant is manning the desk, and are so busy they don't even have time to give you more than a brief scowl.  To the north is a security gate leading into the police station proper, and to the south is an open area with a sign reading "BOOKING."

You can see Sergeant Ramirez here.

You can go south and east from here.

>x ramirez
Seated behind his desk, this grizzled uniformed policeman is clearly a veteran of many years" service.  He scowls at you, waiting for you to make his life more annoying.

>n
You can't go that way.

Sergeant Ramirez picks his nose.

>l
Front Desk
This is the front desk of the police station. A harried sergeant is manning the desk, and are so busy they don't even have time to give you more than a brief scowl.  To the north is a security gate leading into the police station proper, and to the south is an open area with a sign reading "BOOKING."

You can see Sergeant Ramirez here.

You can go south and east from here.

There is a Public Surveillance Notice here.

>open gate
You can't see any such thing.

* * *

Welcome to the future.  Every citizen has been scanned, chipped, folded, spindled and mutilated - and it's enough to make you scream.

Valley of Steel
A tale of the surveillance society by The Custodian of http://everything2.com
Release 1 / Serial number 130328 / Inform 7 build 6G60 (I6/v6.32 lib 6/12N) SD

Bedroom
Your bedroom is rather boring, indicative of how little time you spend in it while awake.  It contains your bed - currently, as always, unmade - and a bedside table with a lamp on it.

On the bedside table are a watch and a phone.

You can go north and west from here.

>purloin knife and key
[Purloined.]
[Purloined.]

* * *

Welcome to the future.  Every citizen has been scanned, chipped, folded, spindled and mutilated - and it's enough to make you scream.

Valley of Steel
A tale of the surveillance society by The Custodian of http://everything2.com
Release 1 / Serial number 130328 / Inform 7 build 6G60 (I6/v6.32 lib 6/12N) SD

Bedroom
Your bedroom is rather boring, indicative of how little time you spend in it while awake.  It contains your bed - currently, as always, unmade - and a bedside table with a lamp on it.

On the bedside table are a watch and a phone.

You can go north and west from here.

>gonear apollo's
Apollo's
Apollo's Coffee is done up in fake Ancient Greek, as befits its name. Plastic busts and columns adorn its facade.  For some reason, there is a silver robotic head behind the counter, mounted on the wall, where a red scanning laser moves monotonously back and forth.

You can go north, northeast and east from here.

>l robotic head
Large and chromed silver, this robot's head looks like a large helmet with rudimentary features.  Instead of eyes, a red band crosses the face, behind which a bright red light slowly moves back and forth.

>take head
That's hardly portable.

>take robotic head
That's hardly portable.

* * *

Welcome to the future.  Every citizen has been scanned, chipped, folded, spindled and mutilated - and it's enough to make you scream.

Valley of Steel
A tale of the surveillance society by The Custodian of http://everything2.com
Release 1 / Serial number 130328 / Inform 7 build 6G60 (I6/v6.32 lib 6/12N) SD

Bedroom
Your bedroom is rather boring, indicative of how little time you spend in it while awake.  It contains your bed - currently, as always, unmade - and a bedside table with a lamp on it.

On the bedside table are a watch and a phone.

You can go north and west from here.

>gonear sergeant ramirez
Front Desk
This is the front desk of the police station. A harried sergeant is manning the desk, and are so busy they don't even have time to give you more than a brief scowl.  To the north is a security gate leading into the police station proper, and to the south is an open area with a sign reading "BOOKING."

You can see Sergeant Ramirez here.

You can go south and east from here.

>n
The security gate is locked.

>open gate
That's not something you can open.

>rules
Rules tracing now switched on. Type "rules off" to switch it off again, or "rules all" to include even rules which do not apply.

>open gate
[Rule "can't open unless openable rule" applies.]
That's not something you can open.

[Rule "Every turn when the player can see Sergeant Ramirez" applies.]
[Rule "Every Turn during Transit Stop" applies.]

>unlock gate
(with the backpack)
[Rule "Every turn when the player can see Sergeant Ramirez" applies.]
Sergeant Ramirez scowls at his paperwork.

[Rule "Every Turn during Transit Stop" applies.]

* * *

Welcome to the future.  Every citizen has been scanned, chipped, folded, spindled and mutilated - and it's enough to make you scream.

Valley of Steel
A tale of the surveillance society by The Custodian of http://everything2.com
Release 1 / Serial number 130328 / Inform 7 build 6G60 (I6/v6.32 lib 6/12N) SD

Bedroom
Your bedroom is rather boring, indicative of how little time you spend in it while awake.  It contains your bed - currently, as always, unmade - and a bedside table with a lamp on it.

On the bedside table are a watch and a phone.

You can go north and west from here.

>gonear garb-oh
(Garb-oh)
Garb-oh
Garb-oh! is a trendy clothing shop.  Images of the shop's icon Greta Garbo abound, each dressed in the clothing item offered on the rack below it.  Jackets, scarves, bandannas, trousers, shirts and more are on inviting display.

On the racks are a blue jacket, a red jacket, a white shirt, a green shirt, a blue pair of pants and a brown pair of pants.

The sales counter runs along the north side of the store.

You can also see the shopkeeper and the shopper here.

You can go east through the Garb-oh door (closed) from here.

>take racks
They're hardly portable.

>move racks
Those are fixed in place.

A small group of people enter the store, look around, look at each other and file back out.

>x racks
Garb-oh has the latest in shiny, innocuous chromed clothing racks.

On the racks are a blue jacket, a red jacket, a white shirt, a green shirt, a blue pair of pants and a brown pair of pants.

>gonear civil center steps
Civil Center Steps
This is the front steps of an impressive government building.  Civil servants hurry in and out through the security checkpoint, going about their business.

The Reserve Bank Spacescraper is visible in the distance, rising over the low skyline.

You can also see Ponyfriend Chunky here.

You can go south from here.

>s
Government Square North
The north half of Government Square is surrounded on three sides by road.  Groundcars trundle back and forth, and the occasional flitter whines down to or screams up from flitter pads near the buildings across it.  The hospital driveway is to the southeast, across the road; the hospital entrance to the east and the police station to the west.  To the north is the steps to the Civil Center, the local government office building.

The Reserve Bank Spacescraper is visible in the distance, rising over the low skyline.

It seems a tourist has left behind a cheap disposable camera, which rests on the sidewalk here.

You can go north to Civil Center Steps, south, southeast, east and west from here.

There is a Public Surveillance Notice here.

>take camera
Taken.

>w
Police Station Steps
These are the busy steps of the local police station.  To the east and southeast is Government Square, while the police station lies at the top to the west. Uniformed police and people in plain clothes are traversing the steps to exit and enter the building.

The Reserve Bank Spacescraper is visible in the distance, rising over the low skyline.

You can go southeast, east to Government Square North and west from here.

There is a Public Surveillance Notice here.

>w
Front Desk
This is the front desk of the police station. A harried sergeant is manning the desk, and are so busy they don't even have time to give you more than a brief scowl.  To the north is a security gate leading into the police station proper, and to the south is an open area with a sign reading "BOOKING."

You can see Sergeant Ramirez here.

You can go south and east to Police Station Steps from here.

There is a Public Surveillance Notice here.

>x ramirez
Seated behind his desk, this grizzled uniformed policeman is clearly a veteran of many years" service.  He scowls at you, waiting for you to make his life more annoying.

Sergeant Ramirez is empty-handed.